producer,duration,start,stop,operation,consumer,time,record
1,178,0,178,1,126,0,3618
1,178,0,178,-1,126,178,11810
1,182,178,360,1,64,178,3619
1,182,178,360,-1,64,360,11811
1,243,360,603,1,110,360,3620
1,243,360,603,-1,110,603,11812
1,154,603,757,1,139,603,3621
1,154,603,757,-1,139,757,11813
1,34,757,791,1,141,757,3622
1,34,757,791,-1,141,791,11814
1,133,791,924,1,38,791,3623
1,133,791,924,-1,38,924,11815
1,214,924,1138,1,43,924,3624
1,214,924,1138,-1,43,1138,11816
1,155,1138,1293,1,242,1138,3625
1,155,1138,1293,-1,242,1293,11817
1,89,1293,1382,1,52,1293,3626
1,89,1293,1382,-1,52,1382,11818
1,224,1382,1606,1,202,1382,3627
1,224,1382,1606,-1,202,1606,11819
1,114,1606,1720,1,193,1606,3628
1,114,1606,1720,-1,193,1720,11820
1,142,1720,1862,1,44,1720,3629
1,142,1720,1862,-1,44,1862,11821
1,242,1862,2104,1,189,1862,3630
1,242,1862,2104,-1,189,2104,11822
1,104,2104,2208,1,233,2104,3631
1,104,2104,2208,-1,233,2208,11823
1,91,2208,2299,1,86,2208,3632
1,91,2208,2299,-1,86,2299,11824
1,64,2299,2363,1,250,2299,3633
1,64,2299,2363,-1,250,2363,11825
1,105,2363,2468,1,117,2363,3634
1,105,2363,2468,-1,117,2468,11826
1,54,2468,2522,1,35,2468,3635
1,54,2468,2522,-1,35,2522,11827
1,267,2522,2789,1,121,2522,3636
1,267,2522,2789,-1,121,2789,11828
1,207,2789,2996,1,154,2789,3637
1,207,2789,2996,-1,154,2996,11829
1,281,2996,3277,1,64,2996,3638
1,281,2996,3277,-1,64,3277,11830
1,93,3277,3370,1,82,3277,3639
1,93,3277,3370,-1,82,3370,11831
1,143,3370,3513,1,254,3370,3640
1,143,3370,3513,-1,254,3513,11832
1,157,3513,3670,1,18,3513,3641
1,157,3513,3670,-1,18,3670,11833
1,121,3670,3791,1,255,3670,3642
1,121,3670,3791,-1,255,3791,11834
1,97,3791,3888,1,117,3791,3643
1,97,3791,3888,-1,117,3888,11835
1,105,3888,3993,1,72,3888,3644
1,105,3888,3993,-1,72,3993,11836
1,134,3993,4127,1,115,3993,3645
1,134,3993,4127,-1,115,4127,11837
1,80,4127,4207,1,145,4127,3646
1,80,4127,4207,-1,145,4207,11838
1,62,4207,4269,1,186,4207,3647
1,62,4207,4269,-1,186,4269,11839
1,221,4269,4490,1,165,4269,3648
1,221,4269,4490,-1,165,4490,11840
1,53,4490,4543,1,33,4490,3649
1,53,4490,4543,-1,33,4543,11841
1,91,4543,4634,1,134,4543,3650
1,91,4543,4634,-1,134,4634,11842
1,133,4634,4767,1,122,4634,3651
1,133,4634,4767,-1,122,4767,11843
1,144,4767,4911,1,52,4767,3652
1,144,4767,4911,-1,52,4911,11844
1,125,4911,5036,1,79,4911,3653
1,125,4911,5036,-1,79,5036,11845
1,113,5036,5149,1,94,5036,3654
1,113,5036,5149,-1,94,5149,11846
1,79,5149,5228,1,4,5149,3655
1,79,5149,5228,-1,4,5228,11847
1,106,5228,5334,1,218,5228,3656
1,106,5228,5334,-1,218,5334,11848
1,159,5334,5493,1,87,5334,3657
1,159,5334,5493,-1,87,5493,11849
1,72,5493,5565,1,182,5493,3658
1,72,5493,5565,-1,182,5565,11850
1,150,5565,5715,1,185,5565,3659
1,150,5565,5715,-1,185,5715,11851
1,119,5715,5834,1,62,5715,3660
1,119,5715,5834,-1,62,5834,11852
1,263,5834,6097,1,34,5834,3661
1,263,5834,6097,-1,34,6097,11853
1,119,6097,6216,1,44,6097,3662
1,119,6097,6216,-1,44,6216,11854
1,217,6216,6433,1,88,6216,3663
1,217,6216,6433,-1,88,6433,11855
1,94,6433,6527,1,116,6433,3664
1,94,6433,6527,-1,116,6527,11856
1,146,6527,6673,1,62,6527,3665
1,146,6527,6673,-1,62,6673,11857
1,216,6673,6889,1,102,6673,3666
1,216,6673,6889,-1,102,6889,11858
1,185,6889,7074,1,227,6889,3667
1,185,6889,7074,-1,227,7074,11859
1,75,7074,7149,1,74,7074,3668
1,75,7074,7149,-1,74,7149,11860
1,90,7149,7239,1,172,7149,3669
1,90,7149,7239,-1,172,7239,11861
1,62,7239,7301,1,176,7239,3670
1,62,7239,7301,-1,176,7301,11862
1,205,7301,7506,1,42,7301,3671
1,205,7301,7506,-1,42,7506,11863
1,259,7506,7765,1,120,7506,3672
1,259,7506,7765,-1,120,7765,11864
1,299,7765,8064,1,127,7765,3673
1,299,7765,8064,-1,127,8064,11865
1,78,8064,8142,1,143,8064,3674
1,78,8064,8142,-1,143,8142,11866
1,100,8142,8242,1,29,8142,3675
1,100,8142,8242,-1,29,8242,11867
1,58,8242,8300,1,94,8242,3676
1,58,8242,8300,-1,94,8300,11868
1,230,8300,8530,1,97,8300,3677
1,230,8300,8530,-1,97,8530,11869
1,83,8530,8613,1,15,8530,3678
1,83,8530,8613,-1,15,8613,11870
1,100,8613,8713,1,175,8613,3679
1,100,8613,8713,-1,175,8713,11871
1,201,8713,8914,1,237,8713,3680
1,201,8713,8914,-1,237,8914,11872
1,36,8914,8950,1,92,8914,3681
1,36,8914,8950,-1,92,8950,11873
1,171,8950,9121,1,40,8950,3682
1,171,8950,9121,-1,40,9121,11874
1,104,9121,9225,1,83,9121,3683
1,104,9121,9225,-1,83,9225,11875
1,171,9225,9396,1,84,9225,3684
1,171,9225,9396,-1,84,9396,11876
1,110,9396,9506,1,175,9396,3685
1,110,9396,9506,-1,175,9506,11877
1,169,9506,9675,1,252,9506,3686
1,169,9506,9675,-1,252,9675,11878
1,222,9675,9897,1,255,9675,3687
1,222,9675,9897,-1,255,9897,11879
1,164,9897,10061,1,200,9897,3688
1,164,9897,10061,-1,200,10061,11880
1,102,10061,10163,1,221,10061,3689
1,102,10061,10163,-1,221,10163,11881
1,63,10163,10226,1,251,10163,3690
1,63,10163,10226,-1,251,10226,11882
1,217,10226,10443,1,200,10226,3691
1,217,10226,10443,-1,200,10443,11883
1,187,10443,10630,1,107,10443,3692
1,187,10443,10630,-1,107,10630,11884
1,170,10630,10800,1,71,10630,3693
1,170,10630,10800,-1,71,10800,11885
1,34,10800,10834,1,8,10800,3694
1,34,10800,10834,-1,8,10834,11886
1,67,10834,10901,1,58,10834,3695
1,67,10834,10901,-1,58,10901,11887
1,72,10901,10973,1,82,10901,3696
1,72,10901,10973,-1,82,10973,11888
1,267,10973,11240,1,62,10973,3697
1,267,10973,11240,-1,62,11240,11889
1,135,11240,11375,1,218,11240,3698
1,135,11240,11375,-1,218,11375,11890
1,180,11375,11555,1,47,11375,3699
1,180,11375,11555,-1,47,11555,11891
1,159,11555,11714,1,8,11555,3700
1,159,11555,11714,-1,8,11714,11892
1,246,11714,11960,1,213,11714,3701
1,246,11714,11960,-1,213,11960,11893
1,171,11960,12131,1,73,11960,3702
1,171,11960,12131,-1,73,12131,11894
1,201,12131,12332,1,199,12131,3703
1,201,12131,12332,-1,199,12332,11895
1,32,12332,12364,1,209,12332,3704
1,32,12332,12364,-1,209,12364,11896
1,87,12364,12451,1,83,12364,3705
1,87,12364,12451,-1,83,12451,11897
1,63,12451,12514,1,148,12451,3706
1,63,12451,12514,-1,148,12514,11898
1,192,12514,12706,1,216,12514,3707
1,192,12514,12706,-1,216,12706,11899
1,176,12706,12882,1,4,12706,3708
1,176,12706,12882,-1,4,12882,11900
1,99,12882,12981,1,255,12882,3709
1,99,12882,12981,-1,255,12981,11901
1,61,12981,13042,1,178,12981,3710
1,61,12981,13042,-1,178,13042,11902
1,175,13042,13217,1,103,13042,3711
1,175,13042,13217,-1,103,13217,11903
1,50,13217,13267,1,37,13217,3712
1,50,13217,13267,-1,37,13267,11904
1,150,13267,13417,1,226,13267,3713
1,150,13267,13417,-1,226,13417,11905
1,134,13417,13551,1,204,13417,3714
1,134,13417,13551,-1,204,13551,11906
1,205,13551,13756,1,132,13551,3715
1,205,13551,13756,-1,132,13756,11907
1,87,13756,13843,1,98,13756,3716
1,87,13756,13843,-1,98,13843,11908
1,95,13843,13938,1,141,13843,3717
1,95,13843,13938,-1,141,13938,11909
1,185,13938,14123,1,226,13938,3718
1,185,13938,14123,-1,226,14123,11910
1,193,14123,14316,1,17,14123,3719
1,193,14123,14316,-1,17,14316,11911
1,211,14316,14527,1,72,14316,3720
1,211,14316,14527,-1,72,14527,11912
1,81,14527,14608,1,232,14527,3721
1,81,14527,14608,-1,232,14608,11913
1,96,14608,14704,1,200,14608,3722
1,96,14608,14704,-1,200,14704,11914
1,172,14704,14876,1,3,14704,3723
1,172,14704,14876,-1,3,14876,11915
1,128,14876,15004,1,90,14876,3724
1,128,14876,15004,-1,90,15004,11916
1,59,15004,15063,1,177,15004,3725
1,59,15004,15063,-1,177,15063,11917
1,113,15063,15176,1,172,15063,3726
1,113,15063,15176,-1,172,15176,11918
1,105,15176,15281,1,194,15176,3727
1,105,15176,15281,-1,194,15281,11919
1,216,15281,15497,1,136,15281,3728
1,216,15281,15497,-1,136,15497,11920
1,84,15497,15581,1,147,15497,3729
1,84,15497,15581,-1,147,15581,11921
1,65,15581,15646,1,249,15581,3730
1,65,15581,15646,-1,249,15646,11922
1,176,15646,15822,1,175,15646,3731
1,176,15646,15822,-1,175,15822,11923
1,176,15822,15998,1,32,15822,3732
1,176,15822,15998,-1,32,15998,11924
1,141,15998,16139,1,164,15998,3733
1,141,15998,16139,-1,164,16139,11925
1,85,16139,16224,1,170,16139,3734
1,85,16139,16224,-1,170,16224,11926
1,32,16224,16256,1,117,16224,3735
1,32,16224,16256,-1,117,16256,11927
1,105,16256,16361,1,31,16256,3736
1,105,16256,16361,-1,31,16361,11928
1,113,16361,16474,1,160,16361,3737
1,113,16361,16474,-1,160,16474,11929
1,108,16474,16582,1,231,16474,3738
1,108,16474,16582,-1,231,16582,11930
1,60,16582,16642,1,105,16582,3739
1,60,16582,16642,-1,105,16642,11931
1,90,16642,16732,1,76,16642,3740
1,90,16642,16732,-1,76,16732,11932
1,227,16732,16959,1,124,16732,3741
1,227,16732,16959,-1,124,16959,11933
1,160,16959,17119,1,124,16959,3742
1,160,16959,17119,-1,124,17119,11934
1,134,17119,17253,1,20,17119,3743
1,134,17119,17253,-1,20,17253,11935
1,285,17253,17538,1,23,17253,3744
1,285,17253,17538,-1,23,17538,11936
1,244,17538,17782,1,147,17538,3745
1,244,17538,17782,-1,147,17782,11937
1,130,17782,17912,1,210,17782,3746
1,130,17782,17912,-1,210,17912,11938
1,73,17912,17985,1,133,17912,3747
1,73,17912,17985,-1,133,17985,11939
1,161,17985,18146,1,206,17985,3748
1,161,17985,18146,-1,206,18146,11940
1,176,18146,18322,1,239,18146,3749
1,176,18146,18322,-1,239,18322,11941
1,148,18322,18470,1,52,18322,3750
1,148,18322,18470,-1,52,18470,11942
1,137,18470,18607,1,139,18470,3751
1,137,18470,18607,-1,139,18607,11943
1,179,18607,18786,1,39,18607,3752
1,179,18607,18786,-1,39,18786,11944
1,198,18786,18984,1,14,18786,3753
1,198,18786,18984,-1,14,18984,11945
1,210,18984,19194,1,16,18984,3754
1,210,18984,19194,-1,16,19194,11946
1,111,19194,19305,1,57,19194,3755
1,111,19194,19305,-1,57,19305,11947
1,176,19305,19481,1,87,19305,3756
1,176,19305,19481,-1,87,19481,11948
1,147,19481,19628,1,87,19481,3757
1,147,19481,19628,-1,87,19628,11949
1,116,19628,19744,1,251,19628,3758
1,116,19628,19744,-1,251,19744,11950
1,194,19744,19938,1,241,19744,3759
1,194,19744,19938,-1,241,19938,11951
1,194,19938,20132,1,72,19938,3760
1,194,19938,20132,-1,72,20132,11952
1,61,20132,20193,1,75,20132,3761
1,61,20132,20193,-1,75,20193,11953
1,240,20193,20433,1,11,20193,3762
1,240,20193,20433,-1,11,20433,11954
1,165,20433,20598,1,12,20433,3763
1,165,20433,20598,-1,12,20598,11955
1,80,20598,20678,1,26,20598,3764
1,80,20598,20678,-1,26,20678,11956
1,75,20678,20753,1,202,20678,3765
1,75,20678,20753,-1,202,20753,11957
1,164,20753,20917,1,90,20753,3766
1,164,20753,20917,-1,90,20917,11958
1,176,20917,21093,1,105,20917,3767
1,176,20917,21093,-1,105,21093,11959
1,39,21093,21132,1,130,21093,3768
1,39,21093,21132,-1,130,21132,11960
1,75,21132,21207,1,105,21132,3769
1,75,21132,21207,-1,105,21207,11961
1,122,21207,21329,1,214,21207,3770
1,122,21207,21329,-1,214,21329,11962
1,91,21329,21420,1,107,21329,3771
1,91,21329,21420,-1,107,21420,11963
1,117,21420,21537,1,143,21420,3772
1,117,21420,21537,-1,143,21537,11964
1,55,21537,21592,1,111,21537,3773
1,55,21537,21592,-1,111,21592,11965
1,239,21592,21831,1,59,21592,3774
1,239,21592,21831,-1,59,21831,11966
1,209,21831,22040,1,241,21831,3775
1,209,21831,22040,-1,241,22040,11967
1,158,22040,22198,1,9,22040,3776
1,158,22040,22198,-1,9,22198,11968
1,226,22198,22424,1,89,22198,3777
1,226,22198,22424,-1,89,22424,11969
1,167,22424,22591,1,56,22424,3778
1,167,22424,22591,-1,56,22591,11970
1,139,22591,22730,1,7,22591,3779
1,139,22591,22730,-1,7,22730,11971
1,182,22730,22912,1,21,22730,3780
1,182,22730,22912,-1,21,22912,11972
1,85,22912,22997,1,76,22912,3781
1,85,22912,22997,-1,76,22997,11973
1,256,22997,23253,1,60,22997,3782
1,256,22997,23253,-1,60,23253,11974
1,108,23253,23361,1,54,23253,3783
1,108,23253,23361,-1,54,23361,11975
1,90,23361,23451,1,191,23361,3784
1,90,23361,23451,-1,191,23451,11976
1,145,23451,23596,1,139,23451,3785
1,145,23451,23596,-1,139,23596,11977
1,251,23596,23847,1,34,23596,3786
1,251,23596,23847,-1,34,23847,11978
1,106,23847,23953,1,83,23847,3787
1,106,23847,23953,-1,83,23953,11979
1,96,23953,24049,1,87,23953,3788
1,96,23953,24049,-1,87,24049,11980
1,178,24049,24227,1,57,24049,3789
1,178,24049,24227,-1,57,24227,11981
1,211,24227,24438,1,38,24227,3790
1,211,24227,24438,-1,38,24438,11982
1,73,24438,24511,1,215,24438,3791
1,73,24438,24511,-1,215,24511,11983
1,58,24511,24569,1,255,24511,3792
1,58,24511,24569,-1,255,24569,11984
1,119,24569,24688,1,93,24569,3793
1,119,24569,24688,-1,93,24688,11985
1,137,24688,24825,1,253,24688,3794
1,137,24688,24825,-1,253,24825,11986
1,89,24825,24914,1,145,24825,3795
1,89,24825,24914,-1,145,24914,11987
1,183,24914,25097,1,6,24914,3796
1,183,24914,25097,-1,6,25097,11988
1,112,25097,25209,1,80,25097,3797
1,112,25097,25209,-1,80,25209,11989
1,88,25209,25297,1,83,25209,3798
1,88,25209,25297,-1,83,25297,11990
1,89,25297,25386,1,142,25297,3799
1,89,25297,25386,-1,142,25386,11991
1,106,25386,25492,1,88,25386,3800
1,106,25386,25492,-1,88,25492,11992
1,245,25492,25737,1,129,25492,3801
1,245,25492,25737,-1,129,25737,11993
1,73,25737,25810,1,112,25737,3802
1,73,25737,25810,-1,112,25810,11994
1,129,25810,25939,1,53,25810,3803
1,129,25810,25939,-1,53,25939,11995
1,198,25939,26137,1,171,25939,3804
1,198,25939,26137,-1,171,26137,11996
1,167,26137,26304,1,122,26137,3805
1,167,26137,26304,-1,122,26304,11997
1,72,26304,26376,1,237,26304,3806
1,72,26304,26376,-1,237,26376,11998
1,120,26376,26496,1,39,26376,3807
1,120,26376,26496,-1,39,26496,11999
1,119,26496,26615,1,177,26496,3808
1,119,26496,26615,-1,177,26615,12000
1,121,26615,26736,1,150,26615,3809
1,121,26615,26736,-1,150,26736,12001
1,50,26736,26786,1,247,26736,3810
1,50,26736,26786,-1,247,26786,12002
1,106,26786,26892,1,217,26786,3811
1,106,26786,26892,-1,217,26892,12003
1,283,26892,27175,1,209,26892,3812
1,283,26892,27175,-1,209,27175,12004
1,76,27175,27251,1,208,27175,3813
1,76,27175,27251,-1,208,27251,12005
1,141,27251,27392,1,61,27251,3814
1,141,27251,27392,-1,61,27392,12006
1,52,27392,27444,1,2,27392,3815
1,52,27392,27444,-1,2,27444,12007
1,35,27444,27479,1,253,27444,3816
1,35,27444,27479,-1,253,27479,12008
1,85,27479,27564,1,193,27479,3817
1,85,27479,27564,-1,193,27564,12009
1,67,27564,27631,1,167,27564,3818
1,67,27564,27631,-1,167,27631,12010
1,50,27631,27681,1,64,27631,3819
1,50,27631,27681,-1,64,27681,12011
1,140,27681,27821,1,131,27681,3820
1,140,27681,27821,-1,131,27821,12012
1,189,27821,28010,1,43,27821,3821
1,189,27821,28010,-1,43,28010,12013
1,166,28010,28176,1,252,28010,3822
1,166,28010,28176,-1,252,28176,12014
1,250,28176,28426,1,236,28176,3823
1,250,28176,28426,-1,236,28426,12015
1,135,28426,28561,1,222,28426,3824
1,135,28426,28561,-1,222,28561,12016
1,89,28561,28650,1,122,28561,3825
1,89,28561,28650,-1,122,28650,12017
1,113,28650,28763,1,64,28650,3826
1,113,28650,28763,-1,64,28763,12018
1,119,28763,28882,1,244,28763,3827
1,119,28763,28882,-1,244,28882,12019
1,116,28882,28998,1,32,28882,3828
1,116,28882,28998,-1,32,28998,12020
1,69,28998,29067,1,18,28998,3829
1,69,28998,29067,-1,18,29067,12021
1,242,29067,29309,1,44,29067,3830
1,242,29067,29309,-1,44,29309,12022
1,87,29309,29396,1,28,29309,3831
1,87,29309,29396,-1,28,29396,12023
1,208,29396,29604,1,143,29396,3832
1,208,29396,29604,-1,143,29604,12024
1,50,29604,29654,1,4,29604,3833
1,50,29604,29654,-1,4,29654,12025
1,76,29654,29730,1,5,29654,3834
1,76,29654,29730,-1,5,29730,12026
1,196,29730,29926,1,7,29730,3835
1,196,29730,29926,-1,7,29926,12027
1,107,29926,30033,1,69,29926,3836
1,107,29926,30033,-1,69,30033,12028
1,94,30033,30127,1,248,30033,3837
1,94,30033,30127,-1,248,30127,12029
1,96,30127,30223,1,23,30127,3838
1,96,30127,30223,-1,23,30223,12030
1,45,30223,30268,1,49,30223,3839
1,45,30223,30268,-1,49,30268,12031
1,244,30268,30512,1,56,30268,3840
1,244,30268,30512,-1,56,30512,12032
1,171,30512,30683,1,208,30512,3841
1,171,30512,30683,-1,208,30683,12033
1,159,30683,30842,1,219,30683,3842
1,159,30683,30842,-1,219,30842,12034
1,114,30842,30956,1,255,30842,3843
1,114,30842,30956,-1,255,30956,12035
1,217,30956,31173,1,235,30956,3844
1,217,30956,31173,-1,235,31173,12036
1,90,31173,31263,1,160,31173,3845
1,90,31173,31263,-1,160,31263,12037
1,52,31263,31315,1,255,31263,3846
1,52,31263,31315,-1,255,31315,12038
1,97,31315,31412,1,15,31315,3847
1,97,31315,31412,-1,15,31412,12039
1,72,31412,31484,1,127,31412,3848
1,72,31412,31484,-1,127,31484,12040
1,109,31484,31593,1,24,31484,3849
1,109,31484,31593,-1,24,31593,12041
1,73,31593,31666,1,67,31593,3850
1,73,31593,31666,-1,67,31666,12042
1,176,31666,31842,1,85,31666,3851
1,176,31666,31842,-1,85,31842,12043
1,127,31842,31969,1,67,31842,3852
1,127,31842,31969,-1,67,31969,12044
1,197,31969,32166,1,152,31969,3853
1,197,31969,32166,-1,152,32166,12045
1,208,32166,32374,1,2,32166,3854
1,208,32166,32374,-1,2,32374,12046
1,219,32374,32593,1,28,32374,3855
1,219,32374,32593,-1,28,32593,12047
1,138,32593,32731,1,126,32593,3856
1,138,32593,32731,-1,126,32731,12048
1,53,32731,32784,1,163,32731,3857
1,53,32731,32784,-1,163,32784,12049
1,114,32784,32898,1,114,32784,3858
1,114,32784,32898,-1,114,32898,12050
1,133,32898,33031,1,62,32898,3859
1,133,32898,33031,-1,62,33031,12051
1,236,33031,33267,1,193,33031,3860
1,236,33031,33267,-1,193,33267,12052
1,261,33267,33528,1,124,33267,3861
1,261,33267,33528,-1,124,33528,12053
1,185,33528,33713,1,10,33528,3862
1,185,33528,33713,-1,10,33713,12054
1,192,33713,33905,1,198,33713,3863
1,192,33713,33905,-1,198,33905,12055
1,91,33905,33996,1,131,33905,3864
1,91,33905,33996,-1,131,33996,12056
1,101,33996,34097,1,40,33996,3865
1,101,33996,34097,-1,40,34097,12057
1,104,34097,34201,1,139,34097,3866
1,104,34097,34201,-1,139,34201,12058
1,281,34201,34482,1,91,34201,3867
1,281,34201,34482,-1,91,34482,12059
1,218,34482,34700,1,47,34482,3868
1,218,34482,34700,-1,47,34700,12060
1,161,34700,34861,1,135,34700,3869
1,161,34700,34861,-1,135,34861,12061
1,201,34861,35062,1,24,34861,3870
1,201,34861,35062,-1,24,35062,12062
1,180,35062,35242,1,47,35062,3871
1,180,35062,35242,-1,47,35242,12063
1,68,35242,35310,1,235,35242,3872
1,68,35242,35310,-1,235,35310,12064
1,94,35310,35404,1,140,35310,3873
1,94,35310,35404,-1,140,35404,12065
1,102,35404,35506,1,194,35404,3874
1,102,35404,35506,-1,194,35506,12066
1,217,35506,35723,1,234,35506,3875
1,217,35506,35723,-1,234,35723,12067
1,108,35723,35831,1,63,35723,3876
1,108,35723,35831,-1,63,35831,12068
1,222,35831,36053,1,32,35831,3877
1,222,35831,36053,-1,32,36053,12069
1,232,36053,36285,1,178,36053,3878
1,232,36053,36285,-1,178,36285,12070
1,104,36285,36389,1,63,36285,3879
1,104,36285,36389,-1,63,36389,12071
1,158,36389,36547,1,158,36389,3880
1,158,36389,36547,-1,158,36547,12072
1,394,36547,36941,1,189,36547,3881
1,394,36547,36941,-1,189,36941,12073
1,131,36941,37072,1,36,36941,3882
1,131,36941,37072,-1,36,37072,12074
1,173,37072,37245,1,140,37072,3883
1,173,37072,37245,-1,140,37245,12075
1,110,37245,37355,1,88,37245,3884
1,110,37245,37355,-1,88,37355,12076
1,86,37355,37441,1,176,37355,3885
1,86,37355,37441,-1,176,37441,12077
1,202,37441,37643,1,88,37441,3886
1,202,37441,37643,-1,88,37643,12078
1,118,37643,37761,1,113,37643,3887
1,118,37643,37761,-1,113,37761,12079
1,89,37761,37850,1,3,37761,3888
1,89,37761,37850,-1,3,37850,12080
1,405,37850,38255,1,166,37850,3889
1,405,37850,38255,-1,166,38255,12081
1,169,38255,38424,1,106,38255,3890
1,169,38255,38424,-1,106,38424,12082
1,196,38424,38620,1,42,38424,3891
1,196,38424,38620,-1,42,38620,12083
1,83,38620,38703,1,2,38620,3892
1,83,38620,38703,-1,2,38703,12084
1,130,38703,38833,1,204,38703,3893
1,130,38703,38833,-1,204,38833,12085
1,209,38833,39042,1,92,38833,3894
1,209,38833,39042,-1,92,39042,12086
1,125,39042,39167,1,148,39042,3895
1,125,39042,39167,-1,148,39167,12087
2,35,0,35,1,20,0,1259
2,35,0,35,-1,20,35,9451
2,231,35,266,1,247,35,1260
2,231,35,266,-1,247,266,9452
2,149,266,415,1,240,266,1261
2,149,266,415,-1,240,415,9453
2,138,415,553,1,42,415,1262
2,138,415,553,-1,42,553,9454
2,146,553,699,1,140,553,1263
2,146,553,699,-1,140,699,9455
2,106,699,805,1,118,699,1264
2,106,699,805,-1,118,805,9456
2,136,805,941,1,28,805,1265
2,136,805,941,-1,28,941,9457
2,72,941,1013,1,184,941,1266
2,72,941,1013,-1,184,1013,9458
2,272,1013,1285,1,14,1013,1267
2,272,1013,1285,-1,14,1285,9459
2,176,1285,1461,1,194,1285,1268
2,176,1285,1461,-1,194,1461,9460
2,57,1461,1518,1,244,1461,1269
2,57,1461,1518,-1,244,1518,9461
2,49,1518,1567,1,254,1518,1270
2,49,1518,1567,-1,254,1567,9462
2,250,1567,1817,1,87,1567,1271
2,250,1567,1817,-1,87,1817,9463
2,98,1817,1915,1,239,1817,1272
2,98,1817,1915,-1,239,1915,9464
2,163,1915,2078,1,81,1915,1273
2,163,1915,2078,-1,81,2078,9465
2,121,2078,2199,1,72,2078,1274
2,121,2078,2199,-1,72,2199,9466
2,109,2199,2308,1,75,2199,1275
2,109,2199,2308,-1,75,2308,9467
2,80,2308,2388,1,241,2308,1276
2,80,2308,2388,-1,241,2388,9468
2,49,2388,2437,1,94,2388,1277
2,49,2388,2437,-1,94,2437,9469
2,163,2437,2600,1,45,2437,1278
2,163,2437,2600,-1,45,2600,9470
2,61,2600,2661,1,165,2600,1279
2,61,2600,2661,-1,165,2661,9471
2,184,2661,2845,1,249,2661,1280
2,184,2661,2845,-1,249,2845,9472
2,153,2845,2998,1,102,2845,1281
2,153,2845,2998,-1,102,2998,9473
2,126,2998,3124,1,172,2998,1282
2,126,2998,3124,-1,172,3124,9474
2,62,3124,3186,1,233,3124,1283
2,62,3124,3186,-1,233,3186,9475
2,99,3186,3285,1,22,3186,1284
2,99,3186,3285,-1,22,3285,9476
2,207,3285,3492,1,83,3285,1285
2,207,3285,3492,-1,83,3492,9477
2,97,3492,3589,1,59,3492,1286
2,97,3492,3589,-1,59,3589,9478
2,178,3589,3767,1,244,3589,1287
2,178,3589,3767,-1,244,3767,9479
2,161,3767,3928,1,140,3767,1288
2,161,3767,3928,-1,140,3928,9480
2,111,3928,4039,1,104,3928,1289
2,111,3928,4039,-1,104,4039,9481
2,26,4039,4065,1,246,4039,1290
2,26,4039,4065,-1,246,4065,9482
2,127,4065,4192,1,86,4065,1291
2,127,4065,4192,-1,86,4192,9483
2,138,4192,4330,1,100,4192,1292
2,138,4192,4330,-1,100,4330,9484
2,59,4330,4389,1,50,4330,1293
2,59,4330,4389,-1,50,4389,9485
2,71,4389,4460,1,17,4389,1294
2,71,4389,4460,-1,17,4460,9486
2,81,4460,4541,1,252,4460,1295
2,81,4460,4541,-1,252,4541,9487
2,96,4541,4637,1,218,4541,1296
2,96,4541,4637,-1,218,4637,9488
2,156,4637,4793,1,89,4637,1297
2,156,4637,4793,-1,89,4793,9489
2,128,4793,4921,1,114,4793,1298
2,128,4793,4921,-1,114,4921,9490
2,123,4921,5044,1,192,4921,1299
2,123,4921,5044,-1,192,5044,9491
2,52,5044,5096,1,150,5044,1300
2,52,5044,5096,-1,150,5096,9492
2,63,5096,5159,1,220,5096,1301
2,63,5096,5159,-1,220,5159,9493
2,194,5159,5353,1,11,5159,1302
2,194,5159,5353,-1,11,5353,9494
2,154,5353,5507,1,193,5353,1303
2,154,5353,5507,-1,193,5507,9495
2,64,5507,5571,1,256,5507,1304
2,64,5507,5571,-1,256,5571,9496
2,161,5571,5732,1,190,5571,1305
2,161,5571,5732,-1,190,5732,9497
2,122,5732,5854,1,223,5732,1306
2,122,5732,5854,-1,223,5854,9498
2,46,5854,5900,1,122,5854,1307
2,46,5854,5900,-1,122,5900,9499
2,169,5900,6069,1,233,5900,1308
2,169,5900,6069,-1,233,6069,9500
2,99,6069,6168,1,83,6069,1309
2,99,6069,6168,-1,83,6168,9501
2,112,6168,6280,1,63,6168,1310
2,112,6168,6280,-1,63,6280,9502
2,126,6280,6406,1,212,6280,1311
2,126,6280,6406,-1,212,6406,9503
2,65,6406,6471,1,166,6406,1312
2,65,6406,6471,-1,166,6471,9504
2,87,6471,6558,1,72,6471,1313
2,87,6471,6558,-1,72,6558,9505
2,103,6558,6661,1,41,6558,1314
2,103,6558,6661,-1,41,6661,9506
2,29,6661,6690,1,223,6661,1315
2,29,6661,6690,-1,223,6690,9507
2,46,6690,6736,1,162,6690,1316
2,46,6690,6736,-1,162,6736,9508
2,160,6736,6896,1,119,6736,1317
2,160,6736,6896,-1,119,6896,9509
2,73,6896,6969,1,53,6896,1318
2,73,6896,6969,-1,53,6969,9510
2,111,6969,7080,1,119,6969,1319
2,111,6969,7080,-1,119,7080,9511
2,19,7080,7099,1,6,7080,1320
2,19,7080,7099,-1,6,7099,9512
2,75,7099,7174,1,203,7099,1321
2,75,7099,7174,-1,203,7174,9513
2,53,7174,7227,1,41,7174,1322
2,53,7174,7227,-1,41,7227,9514
2,180,7227,7407,1,103,7227,1323
2,180,7227,7407,-1,103,7407,9515
2,63,7407,7470,1,129,7407,1324
2,63,7407,7470,-1,129,7470,9516
2,55,7470,7525,1,117,7470,1325
2,55,7470,7525,-1,117,7525,9517
2,110,7525,7635,1,144,7525,1326
2,110,7525,7635,-1,144,7635,9518
2,93,7635,7728,1,192,7635,1327
2,93,7635,7728,-1,192,7728,9519
2,225,7728,7953,1,57,7728,1328
2,225,7728,7953,-1,57,7953,9520
2,131,7953,8084,1,70,7953,1329
2,131,7953,8084,-1,70,8084,9521
2,44,8084,8128,1,114,8084,1330
2,44,8084,8128,-1,114,8128,9522
2,104,8128,8232,1,138,8128,1331
2,104,8128,8232,-1,138,8232,9523
2,151,8232,8383,1,106,8232,1332
2,151,8232,8383,-1,106,8383,9524
2,87,8383,8470,1,178,8383,1333
2,87,8383,8470,-1,178,8470,9525
2,96,8470,8566,1,88,8470,1334
2,96,8470,8566,-1,88,8566,9526
2,132,8566,8698,1,1,8566,1335
2,132,8566,8698,-1,1,8698,9527
2,55,8698,8753,1,227,8698,1336
2,55,8698,8753,-1,227,8753,9528
2,210,8753,8963,1,30,8753,1337
2,210,8753,8963,-1,30,8963,9529
2,157,8963,9120,1,134,8963,1338
2,157,8963,9120,-1,134,9120,9530
2,75,9120,9195,1,69,9120,1339
2,75,9120,9195,-1,69,9195,9531
2,193,9195,9388,1,20,9195,1340
2,193,9195,9388,-1,20,9388,9532
2,40,9388,9428,1,224,9388,1341
2,40,9388,9428,-1,224,9428,9533
2,137,9428,9565,1,50,9428,1342
2,137,9428,9565,-1,50,9565,9534
2,126,9565,9691,1,98,9565,1343
2,126,9565,9691,-1,98,9691,9535
2,187,9691,9878,1,104,9691,1344
2,187,9691,9878,-1,104,9878,9536
2,132,9878,10010,1,241,9878,1345
2,132,9878,10010,-1,241,10010,9537
2,128,10010,10138,1,221,10010,1346
2,128,10010,10138,-1,221,10138,9538
2,177,10138,10315,1,208,10138,1347
2,177,10138,10315,-1,208,10315,9539
2,54,10315,10369,1,23,10315,1348
2,54,10315,10369,-1,23,10369,9540
2,127,10369,10496,1,114,10369,1349
2,127,10369,10496,-1,114,10496,9541
2,122,10496,10618,1,249,10496,1350
2,122,10496,10618,-1,249,10618,9542
2,96,10618,10714,1,128,10618,1351
2,96,10618,10714,-1,128,10714,9543
2,142,10714,10856,1,203,10714,1352
2,142,10714,10856,-1,203,10856,9544
2,122,10856,10978,1,256,10856,1353
2,122,10856,10978,-1,256,10978,9545
2,164,10978,11142,1,84,10978,1354
2,164,10978,11142,-1,84,11142,9546
2,84,11142,11226,1,76,11142,1355
2,84,11142,11226,-1,76,11226,9547
2,65,11226,11291,1,82,11226,1356
2,65,11226,11291,-1,82,11291,9548
2,68,11291,11359,1,70,11291,1357
2,68,11291,11359,-1,70,11359,9549
2,181,11359,11540,1,100,11359,1358
2,181,11359,11540,-1,100,11540,9550
2,103,11540,11643,1,63,11540,1359
2,103,11540,11643,-1,63,11643,9551
2,203,11643,11846,1,80,11643,1360
2,203,11643,11846,-1,80,11846,9552
2,37,11846,11883,1,126,11846,1361
2,37,11846,11883,-1,126,11883,9553
2,122,11883,12005,1,148,11883,1362
2,122,11883,12005,-1,148,12005,9554
2,143,12005,12148,1,41,12005,1363
2,143,12005,12148,-1,41,12148,9555
2,49,12148,12197,1,40,12148,1364
2,49,12148,12197,-1,40,12197,9556
2,55,12197,12252,1,203,12197,1365
2,55,12197,12252,-1,203,12252,9557
2,78,12252,12330,1,113,12252,1366
2,78,12252,12330,-1,113,12330,9558
2,71,12330,12401,1,141,12330,1367
2,71,12330,12401,-1,141,12401,9559
2,102,12401,12503,1,43,12401,1368
2,102,12401,12503,-1,43,12503,9560
2,73,12503,12576,1,253,12503,1369
2,73,12503,12576,-1,253,12576,9561
2,87,12576,12663,1,239,12576,1370
2,87,12576,12663,-1,239,12663,9562
2,91,12663,12754,1,169,12663,1371
2,91,12663,12754,-1,169,12754,9563
2,114,12754,12868,1,116,12754,1372
2,114,12754,12868,-1,116,12868,9564
2,108,12868,12976,1,63,12868,1373
2,108,12868,12976,-1,63,12976,9565
2,215,12976,13191,1,55,12976,1374
2,215,12976,13191,-1,55,13191,9566
2,72,13191,13263,1,232,13191,1375
2,72,13191,13263,-1,232,13263,9567
2,129,13263,13392,1,254,13263,1376
2,129,13263,13392,-1,254,13392,9568
2,109,13392,13501,1,27,13392,1377
2,109,13392,13501,-1,27,13501,9569
2,158,13501,13659,1,214,13501,1378
2,158,13501,13659,-1,214,13659,9570
2,123,13659,13782,1,210,13659,1379
2,123,13659,13782,-1,210,13782,9571
2,56,13782,13838,1,217,13782,1380
2,56,13782,13838,-1,217,13838,9572
2,71,13838,13909,1,134,13838,1381
2,71,13838,13909,-1,134,13909,9573
2,69,13909,13978,1,13,13909,1382
2,69,13909,13978,-1,13,13978,9574
2,205,13978,14183,1,112,13978,1383
2,205,13978,14183,-1,112,14183,9575
2,171,14183,14354,1,25,14183,1384
2,171,14183,14354,-1,25,14354,9576
2,56,14354,14410,1,6,14354,1385
2,56,14354,14410,-1,6,14410,9577
2,128,14410,14538,1,191,14410,1386
2,128,14410,14538,-1,191,14538,9578
2,229,14538,14767,1,67,14538,1387
2,229,14538,14767,-1,67,14767,9579
2,25,14767,14792,1,106,14767,1388
2,25,14767,14792,-1,106,14792,9580
2,206,14792,14998,1,1,14792,1389
2,206,14792,14998,-1,1,14998,9581
2,120,14998,15118,1,95,14998,1390
2,120,14998,15118,-1,95,15118,9582
2,53,15118,15171,1,239,15118,1391
2,53,15118,15171,-1,239,15171,9583
2,33,15171,15204,1,142,15171,1392
2,33,15171,15204,-1,142,15204,9584
2,163,15204,15367,1,204,15204,1393
2,163,15204,15367,-1,204,15367,9585
2,181,15367,15548,1,101,15367,1394
2,181,15367,15548,-1,101,15548,9586
2,75,15548,15623,1,209,15548,1395
2,75,15548,15623,-1,209,15623,9587
2,146,15623,15769,1,84,15623,1396
2,146,15623,15769,-1,84,15769,9588
2,113,15769,15882,1,4,15769,1397
2,113,15769,15882,-1,4,15882,9589
2,164,15882,16046,1,170,15882,1398
2,164,15882,16046,-1,170,16046,9590
2,149,16046,16195,1,138,16046,1399
2,149,16046,16195,-1,138,16195,9591
2,112,16195,16307,1,238,16195,1400
2,112,16195,16307,-1,238,16307,9592
2,86,16307,16393,1,82,16307,1401
2,86,16307,16393,-1,82,16393,9593
2,196,16393,16589,1,130,16393,1402
2,196,16393,16589,-1,130,16589,9594
2,81,16589,16670,1,127,16589,1403
2,81,16589,16670,-1,127,16670,9595
2,101,16670,16771,1,151,16670,1404
2,101,16670,16771,-1,151,16771,9596
2,159,16771,16930,1,197,16771,1405
2,159,16771,16930,-1,197,16930,9597
2,87,16930,17017,1,215,16930,1406
2,87,16930,17017,-1,215,17017,9598
2,178,17017,17195,1,2,17017,1407
2,178,17017,17195,-1,2,17195,9599
2,148,17195,17343,1,154,17195,1408
2,148,17195,17343,-1,154,17343,9600
2,62,17343,17405,1,25,17343,1409
2,62,17343,17405,-1,25,17405,9601
2,67,17405,17472,1,133,17405,1410
2,67,17405,17472,-1,133,17472,9602
2,127,17472,17599,1,223,17472,1411
2,127,17472,17599,-1,223,17599,9603
2,218,17599,17817,1,25,17599,1412
2,218,17599,17817,-1,25,17817,9604
2,61,17817,17878,1,92,17817,1413
2,61,17817,17878,-1,92,17878,9605
2,212,17878,18090,1,237,17878,1414
2,212,17878,18090,-1,237,18090,9606
2,136,18090,18226,1,62,18090,1415
2,136,18090,18226,-1,62,18226,9607
2,138,18226,18364,1,68,18226,1416
2,138,18226,18364,-1,68,18364,9608
2,282,18364,18646,1,159,18364,1417
2,282,18364,18646,-1,159,18646,9609
2,157,18646,18803,1,5,18646,1418
2,157,18646,18803,-1,5,18803,9610
2,88,18803,18891,1,76,18803,1419
2,88,18803,18891,-1,76,18891,9611
2,136,18891,19027,1,253,18891,1420
2,136,18891,19027,-1,253,19027,9612
2,149,19027,19176,1,157,19027,1421
2,149,19027,19176,-1,157,19176,9613
2,195,19176,19371,1,8,19176,1422
2,195,19176,19371,-1,8,19371,9614
2,124,19371,19495,1,38,19371,1423
2,124,19371,19495,-1,38,19495,9615
2,80,19495,19575,1,251,19495,1424
2,80,19495,19575,-1,251,19575,9616
2,40,19575,19615,1,190,19575,1425
2,40,19575,19615,-1,190,19615,9617
2,112,19615,19727,1,121,19615,1426
2,112,19615,19727,-1,121,19727,9618
2,215,19727,19942,1,180,19727,1427
2,215,19727,19942,-1,180,19942,9619
2,49,19942,19991,1,22,19942,1428
2,49,19942,19991,-1,22,19991,9620
2,54,19991,20045,1,77,19991,1429
2,54,19991,20045,-1,77,20045,9621
2,293,20045,20338,1,71,20045,1430
2,293,20045,20338,-1,71,20338,9622
2,86,20338,20424,1,135,20338,1431
2,86,20338,20424,-1,135,20424,9623
2,147,20424,20571,1,34,20424,1432
2,147,20424,20571,-1,34,20571,9624
2,135,20571,20706,1,110,20571,1433
2,135,20571,20706,-1,110,20706,9625
2,59,20706,20765,1,158,20706,1434
2,59,20706,20765,-1,158,20765,9626
2,62,20765,20827,1,179,20765,1435
2,62,20765,20827,-1,179,20827,9627
2,106,20827,20933,1,147,20827,1436
2,106,20827,20933,-1,147,20933,9628
2,233,20933,21166,1,31,20933,1437
2,233,20933,21166,-1,31,21166,9629
2,89,21166,21255,1,159,21166,1438
2,89,21166,21255,-1,159,21255,9630
2,146,21255,21401,1,241,21255,1439
2,146,21255,21401,-1,241,21401,9631
2,115,21401,21516,1,182,21401,1440
2,115,21401,21516,-1,182,21516,9632
2,76,21516,21592,1,163,21516,1441
2,76,21516,21592,-1,163,21592,9633
2,180,21592,21772,1,83,21592,1442
2,180,21592,21772,-1,83,21772,9634
2,139,21772,21911,1,14,21772,1443
2,139,21772,21911,-1,14,21911,9635
2,250,21911,22161,1,46,21911,1444
2,250,21911,22161,-1,46,22161,9636
2,118,22161,22279,1,249,22161,1445
2,118,22161,22279,-1,249,22279,9637
2,142,22279,22421,1,50,22279,1446
2,142,22279,22421,-1,50,22421,9638
2,162,22421,22583,1,256,22421,1447
2,162,22421,22583,-1,256,22583,9639
2,166,22583,22749,1,237,22583,1448
2,166,22583,22749,-1,237,22749,9640
2,137,22749,22886,1,132,22749,1449
2,137,22749,22886,-1,132,22886,9641
2,134,22886,23020,1,171,22886,1450
2,134,22886,23020,-1,171,23020,9642
2,89,23020,23109,1,91,23020,1451
2,89,23020,23109,-1,91,23109,9643
2,129,23109,23238,1,122,23109,1452
2,129,23109,23238,-1,122,23238,9644
2,203,23238,23441,1,47,23238,1453
2,203,23238,23441,-1,47,23441,9645
2,105,23441,23546,1,133,23441,1454
2,105,23441,23546,-1,133,23546,9646
2,110,23546,23656,1,251,23546,1455
2,110,23546,23656,-1,251,23656,9647
2,45,23656,23701,1,163,23656,1456
2,45,23656,23701,-1,163,23701,9648
2,103,23701,23804,1,7,23701,1457
2,103,23701,23804,-1,7,23804,9649
2,91,23804,23895,1,245,23804,1458
2,91,23804,23895,-1,245,23895,9650
2,100,23895,23995,1,131,23895,1459
2,100,23895,23995,-1,131,23995,9651
2,20,23995,24015,1,27,23995,1460
2,20,23995,24015,-1,27,24015,9652
2,60,24015,24075,1,5,24015,1461
2,60,24015,24075,-1,5,24075,9653
2,176,24075,24251,1,121,24075,1462
2,176,24075,24251,-1,121,24251,9654
2,172,24251,24423,1,116,24251,1463
2,172,24251,24423,-1,116,24423,9655
2,138,24423,24561,1,233,24423,1464
2,138,24423,24561,-1,233,24561,9656
2,169,24561,24730,1,111,24561,1465
2,169,24561,24730,-1,111,24730,9657
2,161,24730,24891,1,207,24730,1466
2,161,24730,24891,-1,207,24891,9658
2,142,24891,25033,1,138,24891,1467
2,142,24891,25033,-1,138,25033,9659
2,80,25033,25113,1,241,25033,1468
2,80,25033,25113,-1,241,25113,9660
2,88,25113,25201,1,195,25113,1469
2,88,25113,25201,-1,195,25201,9661
2,92,25201,25293,1,248,25201,1470
2,92,25201,25293,-1,248,25293,9662
2,178,25293,25471,1,186,25293,1471
2,178,25293,25471,-1,186,25471,9663
2,83,25471,25554,1,250,25471,1472
2,83,25471,25554,-1,250,25554,9664
2,81,25554,25635,1,131,25554,1473
2,81,25554,25635,-1,131,25635,9665
2,193,25635,25828,1,33,25635,1474
2,193,25635,25828,-1,33,25828,9666
2,80,25828,25908,1,140,25828,1475
2,80,25828,25908,-1,140,25908,9667
2,146,25908,26054,1,223,25908,1476
2,146,25908,26054,-1,223,26054,9668
2,57,26054,26111,1,53,26054,1477
2,57,26054,26111,-1,53,26111,9669
2,61,26111,26172,1,82,26111,1478
2,61,26111,26172,-1,82,26172,9670
2,96,26172,26268,1,43,26172,1479
2,96,26172,26268,-1,43,26268,9671
2,176,26268,26444,1,203,26268,1480
2,176,26268,26444,-1,203,26444,9672
2,41,26444,26485,1,32,26444,1481
2,41,26444,26485,-1,32,26485,9673
2,110,26485,26595,1,47,26485,1482
2,110,26485,26595,-1,47,26595,9674
2,159,26595,26754,1,27,26595,1483
2,159,26595,26754,-1,27,26754,9675
2,145,26754,26899,1,243,26754,1484
2,145,26754,26899,-1,243,26899,9676
2,66,26899,26965,1,168,26899,1485
2,66,26899,26965,-1,168,26965,9677
2,264,26965,27229,1,207,26965,1486
2,264,26965,27229,-1,207,27229,9678
2,140,27229,27369,1,218,27229,1487
2,140,27229,27369,-1,218,27369,9679
2,48,27369,27417,1,73,27369,1488
2,48,27369,27417,-1,73,27417,9680
2,152,27417,27569,1,169,27417,1489
2,152,27417,27569,-1,169,27569,9681
2,165,27569,27734,1,42,27569,1490
2,165,27569,27734,-1,42,27734,9682
2,62,27734,27796,1,189,27734,1491
2,62,27734,27796,-1,189,27796,9683
2,225,27796,28021,1,126,27796,1492
2,225,27796,28021,-1,126,28021,9684
2,137,28021,28158,1,183,28021,1493
2,137,28021,28158,-1,183,28158,9685
2,203,28158,28361,1,44,28158,1494
2,203,28158,28361,-1,44,28361,9686
2,87,28361,28448,1,9,28361,1495
2,87,28361,28448,-1,9,28448,9687
2,148,28448,28596,1,200,28448,1496
2,148,28448,28596,-1,200,28596,9688
2,159,28596,28755,1,149,28596,1497
2,159,28596,28755,-1,149,28755,9689
2,71,28755,28826,1,46,28755,1498
2,71,28755,28826,-1,46,28826,9690
2,202,28826,29028,1,11,28826,1499
2,202,28826,29028,-1,11,29028,9691
2,164,29028,29192,1,136,29028,1500
2,164,29028,29192,-1,136,29192,9692
2,97,29192,29289,1,33,29192,1501
2,97,29192,29289,-1,33,29289,9693
2,107,29289,29396,1,164,29289,1502
2,107,29289,29396,-1,164,29396,9694
2,138,29396,29534,1,77,29396,1503
2,138,29396,29534,-1,77,29534,9695
2,173,29534,29707,1,34,29534,1504
2,173,29534,29707,-1,34,29707,9696
2,101,29707,29808,1,5,29707,1505
2,101,29707,29808,-1,5,29808,9697
2,106,29808,29914,1,160,29808,1506
2,106,29808,29914,-1,160,29914,9698
2,168,29914,30082,1,87,29914,1507
2,168,29914,30082,-1,87,30082,9699
2,80,30082,30162,1,127,30082,1508
2,80,30082,30162,-1,127,30162,9700
2,78,30162,30240,1,251,30162,1509
2,78,30162,30240,-1,251,30240,9701
2,120,30240,30360,1,112,30240,1510
2,120,30240,30360,-1,112,30360,9702
2,116,30360,30476,1,49,30360,1511
2,116,30360,30476,-1,49,30476,9703
2,158,30476,30634,1,24,30476,1512
2,158,30476,30634,-1,24,30634,9704
2,96,30634,30730,1,60,30634,1513
2,96,30634,30730,-1,60,30730,9705
2,102,30730,30832,1,223,30730,1514
2,102,30730,30832,-1,223,30832,9706
2,142,30832,30974,1,213,30832,1515
2,142,30832,30974,-1,213,30974,9707
2,98,30974,31072,1,8,30974,1516
2,98,30974,31072,-1,8,31072,9708
2,105,31072,31177,1,239,31072,1517
2,105,31072,31177,-1,239,31177,9709
2,109,31177,31286,1,199,31177,1518
2,109,31177,31286,-1,199,31286,9710
2,225,31286,31511,1,127,31286,1519
2,225,31286,31511,-1,127,31511,9711
2,118,31511,31629,1,82,31511,1520
2,118,31511,31629,-1,82,31629,9712
2,172,31629,31801,1,187,31629,1521
2,172,31629,31801,-1,187,31801,9713
2,185,31801,31986,1,128,31801,1522
2,185,31801,31986,-1,128,31986,9714
2,195,31986,32181,1,215,31986,1523
2,195,31986,32181,-1,215,32181,9715
2,81,32181,32262,1,28,32181,1524
2,81,32181,32262,-1,28,32262,9716
2,148,32262,32410,1,82,32262,1525
2,148,32262,32410,-1,82,32410,9717
2,72,32410,32482,1,244,32410,1526
2,72,32410,32482,-1,244,32482,9718
2,102,32482,32584,1,33,32482,1527
2,102,32482,32584,-1,33,32584,9719
2,67,32584,32651,1,213,32584,1528
2,67,32584,32651,-1,213,32651,9720
2,66,32651,32717,1,86,32651,1529
2,66,32651,32717,-1,86,32717,9721
2,52,32717,32769,1,221,32717,1530
2,52,32717,32769,-1,221,32769,9722
2,143,32769,32912,1,126,32769,1531
2,143,32769,32912,-1,126,32912,9723
2,93,32912,33005,1,57,32912,1532
2,93,32912,33005,-1,57,33005,9724
2,60,33005,33065,1,86,33005,1533
2,60,33005,33065,-1,86,33065,9725
2,172,33065,33237,1,7,33065,1534
2,172,33065,33237,-1,7,33237,9726
3,87,0,87,1,184,0,3374
3,87,0,87,-1,184,87,11566
3,75,87,162,1,256,87,3375
3,75,87,162,-1,256,162,11567
3,125,162,287,1,158,162,3376
3,125,162,287,-1,158,287,11568
3,242,287,529,1,242,287,3377
3,242,287,529,-1,242,529,11569
3,43,529,572,1,97,529,3378
3,43,529,572,-1,97,572,11570
3,188,572,760,1,126,572,3379
3,188,572,760,-1,126,760,11571
3,103,760,863,1,5,760,3380
3,103,760,863,-1,5,863,11572
3,103,863,966,1,23,863,3381
3,103,863,966,-1,23,966,11573
3,210,966,1176,1,142,966,3382
3,210,966,1176,-1,142,1176,11574
3,240,1176,1416,1,252,1176,3383
3,240,1176,1416,-1,252,1416,11575
3,200,1416,1616,1,150,1416,3384
3,200,1416,1616,-1,150,1616,11576
3,66,1616,1682,1,132,1616,3385
3,66,1616,1682,-1,132,1682,11577
3,115,1682,1797,1,236,1682,3386
3,115,1682,1797,-1,236,1797,11578
3,168,1797,1965,1,245,1797,3387
3,168,1797,1965,-1,245,1965,11579
3,272,1965,2237,1,21,1965,3388
3,272,1965,2237,-1,21,2237,11580
3,76,2237,2313,1,53,2237,3389
3,76,2237,2313,-1,53,2313,11581
3,188,2313,2501,1,59,2313,3390
3,188,2313,2501,-1,59,2501,11582
3,103,2501,2604,1,235,2501,3391
3,103,2501,2604,-1,235,2604,11583
3,50,2604,2654,1,126,2604,3392
3,50,2604,2654,-1,126,2654,11584
3,210,2654,2864,1,171,2654,3393
3,210,2654,2864,-1,171,2864,11585
3,112,2864,2976,1,166,2864,3394
3,112,2864,2976,-1,166,2976,11586
3,202,2976,3178,1,49,2976,3395
3,202,2976,3178,-1,49,3178,11587
3,78,3178,3256,1,155,3178,3396
3,78,3178,3256,-1,155,3256,11588
3,332,3256,3588,1,87,3256,3397
3,332,3256,3588,-1,87,3588,11589
3,36,3588,3624,1,150,3588,3398
3,36,3588,3624,-1,150,3624,11590
3,255,3624,3879,1,183,3624,3399
3,255,3624,3879,-1,183,3879,11591
3,74,3879,3953,1,87,3879,3400
3,74,3879,3953,-1,87,3953,11592
3,210,3953,4163,1,248,3953,3401
3,210,3953,4163,-1,248,4163,11593
3,159,4163,4322,1,1,4163,3402
3,159,4163,4322,-1,1,4322,11594
3,70,4322,4392,1,7,4322,3403
3,70,4322,4392,-1,7,4392,11595
3,116,4392,4508,1,105,4392,3404
3,116,4392,4508,-1,105,4508,11596
3,136,4508,4644,1,224,4508,3405
3,136,4508,4644,-1,224,4644,11597
3,110,4644,4754,1,253,4644,3406
3,110,4644,4754,-1,253,4754,11598
3,181,4754,4935,1,181,4754,3407
3,181,4754,4935,-1,181,4935,11599
3,83,4935,5018,1,82,4935,3408
3,83,4935,5018,-1,82,5018,11600
3,96,5018,5114,1,155,5018,3409
3,96,5018,5114,-1,155,5114,11601
3,159,5114,5273,1,215,5114,3410
3,159,5114,5273,-1,215,5273,11602
3,100,5273,5373,1,141,5273,3411
3,100,5273,5373,-1,141,5373,11603
3,186,5373,5559,1,250,5373,3412
3,186,5373,5559,-1,250,5559,11604
3,128,5559,5687,1,44,5559,3413
3,128,5559,5687,-1,44,5687,11605
3,172,5687,5859,1,242,5687,3414
3,172,5687,5859,-1,242,5859,11606
3,188,5859,6047,1,236,5859,3415
3,188,5859,6047,-1,236,6047,11607
3,88,6047,6135,1,23,6047,3416
3,88,6047,6135,-1,23,6135,11608
3,127,6135,6262,1,236,6135,3417
3,127,6135,6262,-1,236,6262,11609
3,75,6262,6337,1,84,6262,3418
3,75,6262,6337,-1,84,6337,11610
3,235,6337,6572,1,201,6337,3419
3,235,6337,6572,-1,201,6572,11611
3,67,6572,6639,1,65,6572,3420
3,67,6572,6639,-1,65,6639,11612
3,69,6639,6708,1,46,6639,3421
3,69,6639,6708,-1,46,6708,11613
3,219,6708,6927,1,25,6708,3422
3,219,6708,6927,-1,25,6927,11614
3,64,6927,6991,1,124,6927,3423
3,64,6927,6991,-1,124,6991,11615
3,117,6991,7108,1,38,6991,3424
3,117,6991,7108,-1,38,7108,11616
3,82,7108,7190,1,231,7108,3425
3,82,7108,7190,-1,231,7190,11617
3,76,7190,7266,1,238,7190,3426
3,76,7190,7266,-1,238,7266,11618
3,176,7266,7442,1,168,7266,3427
3,176,7266,7442,-1,168,7442,11619
3,104,7442,7546,1,57,7442,3428
3,104,7442,7546,-1,57,7546,11620
3,134,7546,7680,1,212,7546,3429
3,134,7546,7680,-1,212,7680,11621
3,46,7680,7726,1,96,7680,3430
3,46,7680,7726,-1,96,7726,11622
3,40,7726,7766,1,163,7726,3431
3,40,7726,7766,-1,163,7766,11623
3,137,7766,7903,1,169,7766,3432
3,137,7766,7903,-1,169,7903,11624
3,168,7903,8071,1,245,7903,3433
3,168,7903,8071,-1,245,8071,11625
3,192,8071,8263,1,48,8071,3434
3,192,8071,8263,-1,48,8263,11626
3,109,8263,8372,1,140,8263,3435
3,109,8263,8372,-1,140,8372,11627
3,252,8372,8624,1,251,8372,3436
3,252,8372,8624,-1,251,8624,11628
3,187,8624,8811,1,184,8624,3437
3,187,8624,8811,-1,184,8811,11629
3,228,8811,9039,1,19,8811,3438
3,228,8811,9039,-1,19,9039,11630
3,166,9039,9205,1,105,9039,3439
3,166,9039,9205,-1,105,9205,11631
3,168,9205,9373,1,228,9205,3440
3,168,9205,9373,-1,228,9373,11632
3,108,9373,9481,1,134,9373,3441
3,108,9373,9481,-1,134,9481,11633
3,66,9481,9547,1,116,9481,3442
3,66,9481,9547,-1,116,9547,11634
3,156,9547,9703,1,97,9547,3443
3,156,9547,9703,-1,97,9703,11635
3,62,9703,9765,1,241,9703,3444
3,62,9703,9765,-1,241,9765,11636
3,68,9765,9833,1,183,9765,3445
3,68,9765,9833,-1,183,9833,11637
3,80,9833,9913,1,148,9833,3446
3,80,9833,9913,-1,148,9913,11638
3,222,9913,10135,1,41,9913,3447
3,222,9913,10135,-1,41,10135,11639
3,29,10135,10164,1,240,10135,3448
3,29,10135,10164,-1,240,10164,11640
3,75,10164,10239,1,55,10164,3449
3,75,10164,10239,-1,55,10239,11641
3,145,10239,10384,1,18,10239,3450
3,145,10239,10384,-1,18,10384,11642
3,86,10384,10470,1,19,10384,3451
3,86,10384,10470,-1,19,10470,11643
3,106,10470,10576,1,173,10470,3452
3,106,10470,10576,-1,173,10576,11644
3,92,10576,10668,1,207,10576,3453
3,92,10576,10668,-1,207,10668,11645
3,78,10668,10746,1,103,10668,3454
3,78,10668,10746,-1,103,10746,11646
3,159,10746,10905,1,253,10746,3455
3,159,10746,10905,-1,253,10905,11647
3,105,10905,11010,1,170,10905,3456
3,105,10905,11010,-1,170,11010,11648
3,60,11010,11070,1,7,11010,3457
3,60,11010,11070,-1,7,11070,11649
3,172,11070,11242,1,163,11070,3458
3,172,11070,11242,-1,163,11242,11650
3,206,11242,11448,1,22,11242,3459
3,206,11242,11448,-1,22,11448,11651
3,222,11448,11670,1,68,11448,3460
3,222,11448,11670,-1,68,11670,11652
3,53,11670,11723,1,138,11670,3461
3,53,11670,11723,-1,138,11723,11653
3,159,11723,11882,1,52,11723,3462
3,159,11723,11882,-1,52,11882,11654
3,100,11882,11982,1,5,11882,3463
3,100,11882,11982,-1,5,11982,11655
3,165,11982,12147,1,60,11982,3464
3,165,11982,12147,-1,60,12147,11656
3,173,12147,12320,1,157,12147,3465
3,173,12147,12320,-1,157,12320,11657
3,117,12320,12437,1,15,12320,3466
3,117,12320,12437,-1,15,12437,11658
3,126,12437,12563,1,68,12437,3467
3,126,12437,12563,-1,68,12563,11659
3,183,12563,12746,1,26,12563,3468
3,183,12563,12746,-1,26,12746,11660
3,165,12746,12911,1,147,12746,3469
3,165,12746,12911,-1,147,12911,11661
3,84,12911,12995,1,101,12911,3470
3,84,12911,12995,-1,101,12995,11662
3,133,12995,13128,1,25,12995,3471
3,133,12995,13128,-1,25,13128,11663
3,80,13128,13208,1,56,13128,3472
3,80,13128,13208,-1,56,13208,11664
3,123,13208,13331,1,207,13208,3473
3,123,13208,13331,-1,207,13331,11665
3,193,13331,13524,1,29,13331,3474
3,193,13331,13524,-1,29,13524,11666
3,142,13524,13666,1,115,13524,3475
3,142,13524,13666,-1,115,13666,11667
3,244,13666,13910,1,75,13666,3476
3,244,13666,13910,-1,75,13910,11668
3,119,13910,14029,1,138,13910,3477
3,119,13910,14029,-1,138,14029,11669
3,140,14029,14169,1,57,14029,3478
3,140,14029,14169,-1,57,14169,11670
3,168,14169,14337,1,157,14169,3479
3,168,14169,14337,-1,157,14337,11671
3,127,14337,14464,1,79,14337,3480
3,127,14337,14464,-1,79,14464,11672
3,275,14464,14739,1,174,14464,3481
3,275,14464,14739,-1,174,14739,11673
3,61,14739,14800,1,69,14739,3482
3,61,14739,14800,-1,69,14800,11674
3,88,14800,14888,1,98,14800,3483
3,88,14800,14888,-1,98,14888,11675
3,141,14888,15029,1,112,14888,3484
3,141,14888,15029,-1,112,15029,11676
3,61,15029,15090,1,211,15029,3485
3,61,15029,15090,-1,211,15090,11677
3,180,15090,15270,1,125,15090,3486
3,180,15090,15270,-1,125,15270,11678
3,56,15270,15326,1,127,15270,3487
3,56,15270,15326,-1,127,15326,11679
3,142,15326,15468,1,208,15326,3488
3,142,15326,15468,-1,208,15468,11680
3,244,15468,15712,1,124,15468,3489
3,244,15468,15712,-1,124,15712,11681
3,69,15712,15781,1,205,15712,3490
3,69,15712,15781,-1,205,15781,11682
3,113,15781,15894,1,255,15781,3491
3,113,15781,15894,-1,255,15894,11683
3,119,15894,16013,1,16,15894,3492
3,119,15894,16013,-1,16,16013,11684
3,158,16013,16171,1,58,16013,3493
3,158,16013,16171,-1,58,16171,11685
3,213,16171,16384,1,244,16171,3494
3,213,16171,16384,-1,244,16384,11686
3,81,16384,16465,1,71,16384,3495
3,81,16384,16465,-1,71,16465,11687
3,110,16465,16575,1,16,16465,3496
3,110,16465,16575,-1,16,16575,11688
3,197,16575,16772,1,165,16575,3497
3,197,16575,16772,-1,165,16772,11689
3,88,16772,16860,1,144,16772,3498
3,88,16772,16860,-1,144,16860,11690
3,56,16860,16916,1,62,16860,3499
3,56,16860,16916,-1,62,16916,11691
3,112,16916,17028,1,139,16916,3500
3,112,16916,17028,-1,139,17028,11692
3,183,17028,17211,1,149,17028,3501
3,183,17028,17211,-1,149,17211,11693
3,51,17211,17262,1,100,17211,3502
3,51,17211,17262,-1,100,17262,11694
3,120,17262,17382,1,211,17262,3503
3,120,17262,17382,-1,211,17382,11695
3,38,17382,17420,1,173,17382,3504
3,38,17382,17420,-1,173,17420,11696
3,51,17420,17471,1,146,17420,3505
3,51,17420,17471,-1,146,17471,11697
3,37,17471,17508,1,179,17471,3506
3,37,17471,17508,-1,179,17508,11698
3,119,17508,17627,1,158,17508,3507
3,119,17508,17627,-1,158,17627,11699
3,203,17627,17830,1,43,17627,3508
3,203,17627,17830,-1,43,17830,11700
3,152,17830,17982,1,196,17830,3509
3,152,17830,17982,-1,196,17982,11701
3,97,17982,18079,1,250,17982,3510
3,97,17982,18079,-1,250,18079,11702
3,106,18079,18185,1,103,18079,3511
3,106,18079,18185,-1,103,18185,11703
3,148,18185,18333,1,198,18185,3512
3,148,18185,18333,-1,198,18333,11704
3,55,18333,18388,1,99,18333,3513
3,55,18333,18388,-1,99,18388,11705
3,166,18388,18554,1,113,18388,3514
3,166,18388,18554,-1,113,18554,11706
3,96,18554,18650,1,208,18554,3515
3,96,18554,18650,-1,208,18650,11707
3,201,18650,18851,1,45,18650,3516
3,201,18650,18851,-1,45,18851,11708
3,151,18851,19002,1,149,18851,3517
3,151,18851,19002,-1,149,19002,11709
3,121,19002,19123,1,215,19002,3518
3,121,19002,19123,-1,215,19123,11710
3,78,19123,19201,1,69,19123,3519
3,78,19123,19201,-1,69,19201,11711
3,95,19201,19296,1,239,19201,3520
3,95,19201,19296,-1,239,19296,11712
3,159,19296,19455,1,252,19296,3521
3,159,19296,19455,-1,252,19455,11713
3,91,19455,19546,1,76,19455,3522
3,91,19455,19546,-1,76,19546,11714
3,116,19546,19662,1,167,19546,3523
3,116,19546,19662,-1,167,19662,11715
3,171,19662,19833,1,152,19662,3524
3,171,19662,19833,-1,152,19833,11716
3,133,19833,19966,1,97,19833,3525
3,133,19833,19966,-1,97,19966,11717
3,162,19966,20128,1,223,19966,3526
3,162,19966,20128,-1,223,20128,11718
3,51,20128,20179,1,153,20128,3527
3,51,20128,20179,-1,153,20179,11719
3,92,20179,20271,1,29,20179,3528
3,92,20179,20271,-1,29,20271,11720
3,92,20271,20363,1,133,20271,3529
3,92,20271,20363,-1,133,20363,11721
3,126,20363,20489,1,3,20363,3530
3,126,20363,20489,-1,3,20489,11722
3,169,20489,20658,1,77,20489,3531
3,169,20489,20658,-1,77,20658,11723
3,42,20658,20700,1,244,20658,3532
3,42,20658,20700,-1,244,20700,11724
3,108,20700,20808,1,224,20700,3533
3,108,20700,20808,-1,224,20808,11725
3,86,20808,20894,1,30,20808,3534
3,86,20808,20894,-1,30,20894,11726
3,176,20894,21070,1,80,20894,3535
3,176,20894,21070,-1,80,21070,11727
3,72,21070,21142,1,173,21070,3536
3,72,21070,21142,-1,173,21142,11728
3,157,21142,21299,1,163,21142,3537
3,157,21142,21299,-1,163,21299,11729
3,65,21299,21364,1,123,21299,3538
3,65,21299,21364,-1,123,21364,11730
3,148,21364,21512,1,227,21364,3539
3,148,21364,21512,-1,227,21512,11731
3,153,21512,21665,1,58,21512,3540
3,153,21512,21665,-1,58,21665,11732
3,111,21665,21776,1,197,21665,3541
3,111,21665,21776,-1,197,21776,11733
3,175,21776,21951,1,38,21776,3542
3,175,21776,21951,-1,38,21951,11734
3,161,21951,22112,1,36,21951,3543
3,161,21951,22112,-1,36,22112,11735
3,98,22112,22210,1,30,22112,3544
3,98,22112,22210,-1,30,22210,11736
3,141,22210,22351,1,104,22210,3545
3,141,22210,22351,-1,104,22351,11737
3,52,22351,22403,1,167,22351,3546
3,52,22351,22403,-1,167,22403,11738
3,182,22403,22585,1,212,22403,3547
3,182,22403,22585,-1,212,22585,11739
3,61,22585,22646,1,153,22585,3548
3,61,22585,22646,-1,153,22646,11740
3,76,22646,22722,1,217,22646,3549
3,76,22646,22722,-1,217,22722,11741
3,109,22722,22831,1,156,22722,3550
3,109,22722,22831,-1,156,22831,11742
3,79,22831,22910,1,185,22831,3551
3,79,22831,22910,-1,185,22910,11743
3,131,22910,23041,1,93,22910,3552
3,131,22910,23041,-1,93,23041,11744
3,154,23041,23195,1,253,23041,3553
3,154,23041,23195,-1,253,23195,11745
3,60,23195,23255,1,53,23195,3554
3,60,23195,23255,-1,53,23255,11746
3,164,23255,23419,1,243,23255,3555
3,164,23255,23419,-1,243,23419,11747
3,102,23419,23521,1,176,23419,3556
3,102,23419,23521,-1,176,23521,11748
3,57,23521,23578,1,44,23521,3557
3,57,23521,23578,-1,44,23578,11749
3,30,23578,23608,1,29,23578,3558
3,30,23578,23608,-1,29,23608,11750
3,93,23608,23701,1,81,23608,3559
3,93,23608,23701,-1,81,23701,11751
3,61,23701,23762,1,181,23701,3560
3,61,23701,23762,-1,181,23762,11752
3,69,23762,23831,1,9,23762,3561
3,69,23762,23831,-1,9,23831,11753
3,132,23831,23963,1,122,23831,3562
3,132,23831,23963,-1,122,23963,11754
3,139,23963,24102,1,138,23963,3563
3,139,23963,24102,-1,138,24102,11755
3,100,24102,24202,1,14,24102,3564
3,100,24102,24202,-1,14,24202,11756
3,73,24202,24275,1,140,24202,3565
3,73,24202,24275,-1,140,24275,11757
3,182,24275,24457,1,103,24275,3566
3,182,24275,24457,-1,103,24457,11758
3,142,24457,24599,1,54,24457,3567
3,142,24457,24599,-1,54,24599,11759
3,149,24599,24748,1,49,24599,3568
3,149,24599,24748,-1,49,24748,11760
3,175,24748,24923,1,53,24748,3569
3,175,24748,24923,-1,53,24923,11761
3,74,24923,24997,1,203,24923,3570
3,74,24923,24997,-1,203,24997,11762
3,94,24997,25091,1,147,24997,3571
3,94,24997,25091,-1,147,25091,11763
3,154,25091,25245,1,92,25091,3572
3,154,25091,25245,-1,92,25245,11764
3,253,25245,25498,1,104,25245,3573
3,253,25245,25498,-1,104,25498,11765
3,185,25498,25683,1,133,25498,3574
3,185,25498,25683,-1,133,25683,11766
3,107,25683,25790,1,62,25683,3575
3,107,25683,25790,-1,62,25790,11767
3,123,25790,25913,1,189,25790,3576
3,123,25790,25913,-1,189,25913,11768
3,185,25913,26098,1,149,25913,3577
3,185,25913,26098,-1,149,26098,11769
3,124,26098,26222,1,218,26098,3578
3,124,26098,26222,-1,218,26222,11770
3,117,26222,26339,1,28,26222,3579
3,117,26222,26339,-1,28,26339,11771
3,131,26339,26470,1,104,26339,3580
3,131,26339,26470,-1,104,26470,11772
3,101,26470,26571,1,220,26470,3581
3,101,26470,26571,-1,220,26571,11773
3,81,26571,26652,1,138,26571,3582
3,81,26571,26652,-1,138,26652,11774
3,185,26652,26837,1,217,26652,3583
3,185,26652,26837,-1,217,26837,11775
3,264,26837,27101,1,189,26837,3584
3,264,26837,27101,-1,189,27101,11776
3,147,27101,27248,1,169,27101,3585
3,147,27101,27248,-1,169,27248,11777
3,65,27248,27313,1,251,27248,3586
3,65,27248,27313,-1,251,27313,11778
3,124,27313,27437,1,110,27313,3587
3,124,27313,27437,-1,110,27437,11779
3,85,27437,27522,1,241,27437,3588
3,85,27437,27522,-1,241,27522,11780
3,56,27522,27578,1,81,27522,3589
3,56,27522,27578,-1,81,27578,11781
3,114,27578,27692,1,81,27578,3590
3,114,27578,27692,-1,81,27692,11782
3,154,27692,27846,1,129,27692,3591
3,154,27692,27846,-1,129,27846,11783
3,54,27846,27900,1,249,27846,3592
3,54,27846,27900,-1,249,27900,11784
3,84,27900,27984,1,48,27900,3593
3,84,27900,27984,-1,48,27984,11785
3,96,27984,28080,1,64,27984,3594
3,96,27984,28080,-1,64,28080,11786
3,109,28080,28189,1,14,28080,3595
3,109,28080,28189,-1,14,28189,11787
3,186,28189,28375,1,116,28189,3596
3,186,28189,28375,-1,116,28375,11788
3,334,28375,28709,1,100,28375,3597
3,334,28375,28709,-1,100,28709,11789
3,104,28709,28813,1,214,28709,3598
3,104,28709,28813,-1,214,28813,11790
3,62,28813,28875,1,249,28813,3599
3,62,28813,28875,-1,249,28875,11791
3,106,28875,28981,1,95,28875,3600
3,106,28875,28981,-1,95,28981,11792
3,233,28981,29214,1,250,28981,3601
3,233,28981,29214,-1,250,29214,11793
3,145,29214,29359,1,119,29214,3602
3,145,29214,29359,-1,119,29359,11794
3,140,29359,29499,1,145,29359,3603
3,140,29359,29499,-1,145,29499,11795
3,216,29499,29715,1,72,29499,3604
3,216,29499,29715,-1,72,29715,11796
3,44,29715,29759,1,207,29715,3605
3,44,29715,29759,-1,207,29759,11797
3,125,29759,29884,1,50,29759,3606
3,125,29759,29884,-1,50,29884,11798
3,130,29884,30014,1,118,29884,3607
3,130,29884,30014,-1,118,30014,11799
3,208,30014,30222,1,152,30014,3608
3,208,30014,30222,-1,152,30222,11800
3,114,30222,30336,1,100,30222,3609
3,114,30222,30336,-1,100,30336,11801
3,112,30336,30448,1,256,30336,3610
3,112,30336,30448,-1,256,30448,11802
3,236,30448,30684,1,213,30448,3611
3,236,30448,30684,-1,213,30684,11803
3,89,30684,30773,1,46,30684,3612
3,89,30684,30773,-1,46,30773,11804
3,91,30773,30864,1,84,30773,3613
3,91,30773,30864,-1,84,30864,11805
3,55,30864,30919,1,57,30864,3614
3,55,30864,30919,-1,57,30919,11806
3,56,30919,30975,1,55,30919,3615
3,56,30919,30975,-1,55,30975,11807
3,168,30975,31143,1,34,30975,3616
3,168,30975,31143,-1,34,31143,11808
3,61,31143,31204,1,108,31143,3617
3,61,31143,31204,-1,108,31204,11809
4,99,0,99,1,33,0,4915
4,99,0,99,-1,33,99,13107
4,146,99,245,1,68,99,4916
4,146,99,245,-1,68,245,13108
4,105,245,350,1,245,245,4917
4,105,245,350,-1,245,350,13109
4,58,350,408,1,165,350,4918
4,58,350,408,-1,165,408,13110
4,33,408,441,1,222,408,4919
4,33,408,441,-1,222,441,13111
4,75,441,516,1,110,441,4920
4,75,441,516,-1,110,516,13112
4,55,516,571,1,98,516,4921
4,55,516,571,-1,98,571,13113
4,119,571,690,1,191,571,4922
4,119,571,690,-1,191,690,13114
4,205,690,895,1,45,690,4923
4,205,690,895,-1,45,895,13115
4,113,895,1008,1,81,895,4924
4,113,895,1008,-1,81,1008,13116
4,59,1008,1067,1,175,1008,4925
4,59,1008,1067,-1,175,1067,13117
4,120,1067,1187,1,53,1067,4926
4,120,1067,1187,-1,53,1187,13118
4,95,1187,1282,1,55,1187,4927
4,95,1187,1282,-1,55,1282,13119
4,149,1282,1431,1,97,1282,4928
4,149,1282,1431,-1,97,1431,13120
4,198,1431,1629,1,63,1431,4929
4,198,1431,1629,-1,63,1629,13121
4,138,1629,1767,1,40,1629,4930
4,138,1629,1767,-1,40,1767,13122
4,106,1767,1873,1,252,1767,4931
4,106,1767,1873,-1,252,1873,13123
4,153,1873,2026,1,163,1873,4932
4,153,1873,2026,-1,163,2026,13124
4,130,2026,2156,1,87,2026,4933
4,130,2026,2156,-1,87,2156,13125
4,83,2156,2239,1,126,2156,4934
4,83,2156,2239,-1,126,2239,13126
4,88,2239,2327,1,76,2239,4935
4,88,2239,2327,-1,76,2327,13127
4,178,2327,2505,1,225,2327,4936
4,178,2327,2505,-1,225,2505,13128
4,158,2505,2663,1,113,2505,4937
4,158,2505,2663,-1,113,2663,13129
4,224,2663,2887,1,251,2663,4938
4,224,2663,2887,-1,251,2887,13130
4,97,2887,2984,1,35,2887,4939
4,97,2887,2984,-1,35,2984,13131
4,73,2984,3057,1,215,2984,4940
4,73,2984,3057,-1,215,3057,13132
4,189,3057,3246,1,166,3057,4941
4,189,3057,3246,-1,166,3246,13133
4,55,3246,3301,1,83,3246,4942
4,55,3246,3301,-1,83,3301,13134
4,78,3301,3379,1,85,3301,4943
4,78,3301,3379,-1,85,3379,13135
4,104,3379,3483,1,189,3379,4944
4,104,3379,3483,-1,189,3483,13136
4,237,3483,3720,1,57,3483,4945
4,237,3483,3720,-1,57,3720,13137
4,59,3720,3779,1,8,3720,4946
4,59,3720,3779,-1,8,3779,13138
4,22,3779,3801,1,248,3779,4947
4,22,3779,3801,-1,248,3801,13139
4,44,3801,3845,1,231,3801,4948
4,44,3801,3845,-1,231,3845,13140
4,161,3845,4006,1,249,3845,4949
4,161,3845,4006,-1,249,4006,13141
4,66,4006,4072,1,139,4006,4950
4,66,4006,4072,-1,139,4072,13142
4,139,4072,4211,1,179,4072,4951
4,139,4072,4211,-1,179,4211,13143
4,98,4211,4309,1,206,4211,4952
4,98,4211,4309,-1,206,4309,13144
4,69,4309,4378,1,12,4309,4953
4,69,4309,4378,-1,12,4378,13145
4,57,4378,4435,1,17,4378,4954
4,57,4378,4435,-1,17,4435,13146
4,163,4435,4598,1,243,4435,4955
4,163,4435,4598,-1,243,4598,13147
4,60,4598,4658,1,57,4598,4956
4,60,4598,4658,-1,57,4658,13148
4,152,4658,4810,1,44,4658,4957
4,152,4658,4810,-1,44,4810,13149
4,215,4810,5025,1,140,4810,4958
4,215,4810,5025,-1,140,5025,13150
4,68,5025,5093,1,168,5025,4959
4,68,5025,5093,-1,168,5093,13151
4,165,5093,5258,1,123,5093,4960
4,165,5093,5258,-1,123,5258,13152
4,146,5258,5404,1,25,5258,4961
4,146,5258,5404,-1,25,5404,13153
4,64,5404,5468,1,26,5404,4962
4,64,5404,5468,-1,26,5468,13154
4,119,5468,5587,1,212,5468,4963
4,119,5468,5587,-1,212,5587,13155
4,103,5587,5690,1,36,5587,4964
4,103,5587,5690,-1,36,5690,13156
4,113,5690,5803,1,152,5690,4965
4,113,5690,5803,-1,152,5803,13157
4,111,5803,5914,1,187,5803,4966
4,111,5803,5914,-1,187,5914,13158
4,176,5914,6090,1,188,5914,4967
4,176,5914,6090,-1,188,6090,13159
4,160,6090,6250,1,59,6090,4968
4,160,6090,6250,-1,59,6250,13160
4,108,6250,6358,1,160,6250,4969
4,108,6250,6358,-1,160,6358,13161
4,84,6358,6442,1,46,6358,4970
4,84,6358,6442,-1,46,6442,13162
4,49,6442,6491,1,175,6442,4971
4,49,6442,6491,-1,175,6491,13163
4,224,6491,6715,1,70,6491,4972
4,224,6491,6715,-1,70,6715,13164
4,151,6715,6866,1,117,6715,4973
4,151,6715,6866,-1,117,6866,13165
4,100,6866,6966,1,7,6866,4974
4,100,6866,6966,-1,7,6966,13166
4,53,6966,7019,1,148,6966,4975
4,53,6966,7019,-1,148,7019,13167
4,241,7019,7260,1,29,7019,4976
4,241,7019,7260,-1,29,7260,13168
4,42,7260,7302,1,65,7260,4977
4,42,7260,7302,-1,65,7302,13169
4,96,7302,7398,1,250,7302,4978
4,96,7302,7398,-1,250,7398,13170
4,308,7398,7706,1,158,7398,4979
4,308,7398,7706,-1,158,7706,13171
4,55,7706,7761,1,227,7706,4980
4,55,7706,7761,-1,227,7761,13172
4,126,7761,7887,1,81,7761,4981
4,126,7761,7887,-1,81,7887,13173
4,25,7887,7912,1,13,7887,4982
4,25,7887,7912,-1,13,7912,13174
4,62,7912,7974,1,235,7912,4983
4,62,7912,7974,-1,235,7974,13175
4,187,7974,8161,1,116,7974,4984
4,187,7974,8161,-1,116,8161,13176
4,114,8161,8275,1,89,8161,4985
4,114,8161,8275,-1,89,8275,13177
4,29,8275,8304,1,31,8275,4986
4,29,8275,8304,-1,31,8304,13178
4,151,8304,8455,1,208,8304,4987
4,151,8304,8455,-1,208,8455,13179
4,113,8455,8568,1,38,8455,4988
4,113,8455,8568,-1,38,8568,13180
4,43,8568,8611,1,59,8568,4989
4,43,8568,8611,-1,59,8611,13181
4,36,8611,8647,1,30,8611,4990
4,36,8611,8647,-1,30,8647,13182
4,226,8647,8873,1,51,8647,4991
4,226,8647,8873,-1,51,8873,13183
4,59,8873,8932,1,57,8873,4992
4,59,8873,8932,-1,57,8932,13184
4,160,8932,9092,1,59,8932,4993
4,160,8932,9092,-1,59,9092,13185
4,186,9092,9278,1,39,9092,4994
4,186,9092,9278,-1,39,9278,13186
4,224,9278,9502,1,121,9278,4995
4,224,9278,9502,-1,121,9502,13187
4,87,9502,9589,1,167,9502,4996
4,87,9502,9589,-1,167,9589,13188
4,88,9589,9677,1,148,9589,4997
4,88,9589,9677,-1,148,9677,13189
4,167,9677,9844,1,30,9677,4998
4,167,9677,9844,-1,30,9844,13190
4,190,9844,10034,1,148,9844,4999
4,190,9844,10034,-1,148,10034,13191
4,141,10034,10175,1,178,10034,5000
4,141,10034,10175,-1,178,10175,13192
4,156,10175,10331,1,212,10175,5001
4,156,10175,10331,-1,212,10331,13193
4,87,10331,10418,1,83,10331,5002
4,87,10331,10418,-1,83,10418,13194
4,114,10418,10532,1,245,10418,5003
4,114,10418,10532,-1,245,10532,13195
4,165,10532,10697,1,205,10532,5004
4,165,10532,10697,-1,205,10697,13196
4,82,10697,10779,1,121,10697,5005
4,82,10697,10779,-1,121,10779,13197
4,85,10779,10864,1,67,10779,5006
4,85,10779,10864,-1,67,10864,13198
4,189,10864,11053,1,199,10864,5007
4,189,10864,11053,-1,199,11053,13199
4,111,11053,11164,1,4,11053,5008
4,111,11053,11164,-1,4,11164,13200
4,87,11164,11251,1,148,11164,5009
4,87,11164,11251,-1,148,11251,13201
4,89,11251,11340,1,117,11251,5010
4,89,11251,11340,-1,117,11340,13202
4,117,11340,11457,1,50,11340,5011
4,117,11340,11457,-1,50,11457,13203
4,65,11457,11522,1,185,11457,5012
4,65,11457,11522,-1,185,11522,13204
4,146,11522,11668,1,244,11522,5013
4,146,11522,11668,-1,244,11668,13205
4,110,11668,11778,1,205,11668,5014
4,110,11668,11778,-1,205,11778,13206
4,49,11778,11827,1,53,11778,5015
4,49,11778,11827,-1,53,11827,13207
4,66,11827,11893,1,11,11827,5016
4,66,11827,11893,-1,11,11893,13208
4,217,11893,12110,1,221,11893,5017
4,217,11893,12110,-1,221,12110,13209
4,126,12110,12236,1,220,12110,5018
4,126,12110,12236,-1,220,12236,13210
4,49,12236,12285,1,6,12236,5019
4,49,12236,12285,-1,6,12285,13211
4,120,12285,12405,1,34,12285,5020
4,120,12285,12405,-1,34,12405,13212
4,92,12405,12497,1,182,12405,5021
4,92,12405,12497,-1,182,12497,13213
4,183,12497,12680,1,193,12497,5022
4,183,12497,12680,-1,193,12680,13214
4,73,12680,12753,1,175,12680,5023
4,73,12680,12753,-1,175,12753,13215
4,163,12753,12916,1,27,12753,5024
4,163,12753,12916,-1,27,12916,13216
4,73,12916,12989,1,27,12916,5025
4,73,12916,12989,-1,27,12989,13217
4,34,12989,13023,1,19,12989,5026
4,34,12989,13023,-1,19,13023,13218
4,190,13023,13213,1,219,13023,5027
4,190,13023,13213,-1,219,13213,13219
4,109,13213,13322,1,111,13213,5028
4,109,13213,13322,-1,111,13322,13220
4,113,13322,13435,1,124,13322,5029
4,113,13322,13435,-1,124,13435,13221
4,172,13435,13607,1,201,13435,5030
4,172,13435,13607,-1,201,13607,13222
4,44,13607,13651,1,97,13607,5031
4,44,13607,13651,-1,97,13651,13223
4,85,13651,13736,1,137,13651,5032
4,85,13651,13736,-1,137,13736,13224
4,118,13736,13854,1,90,13736,5033
4,118,13736,13854,-1,90,13854,13225
4,225,13854,14079,1,38,13854,5034
4,225,13854,14079,-1,38,14079,13226
4,57,14079,14136,1,33,14079,5035
4,57,14079,14136,-1,33,14136,13227
4,175,14136,14311,1,168,14136,5036
4,175,14136,14311,-1,168,14311,13228
4,81,14311,14392,1,147,14311,5037
4,81,14311,14392,-1,147,14392,13229
4,82,14392,14474,1,80,14392,5038
4,82,14392,14474,-1,80,14474,13230
4,39,14474,14513,1,210,14474,5039
4,39,14474,14513,-1,210,14513,13231
4,38,14513,14551,1,62,14513,5040
4,38,14513,14551,-1,62,14551,13232
4,65,14551,14616,1,79,14551,5041
4,65,14551,14616,-1,79,14616,13233
4,48,14616,14664,1,39,14616,5042
4,48,14616,14664,-1,39,14664,13234
4,140,14664,14804,1,212,14664,5043
4,140,14664,14804,-1,212,14804,13235
4,168,14804,14972,1,240,14804,5044
4,168,14804,14972,-1,240,14972,13236
4,177,14972,15149,1,223,14972,5045
4,177,14972,15149,-1,223,15149,13237
4,267,15149,15416,1,112,15149,5046
4,267,15149,15416,-1,112,15416,13238
4,152,15416,15568,1,8,15416,5047
4,152,15416,15568,-1,8,15568,13239
4,69,15568,15637,1,180,15568,5048
4,69,15568,15637,-1,180,15637,13240
4,190,15637,15827,1,129,15637,5049
4,190,15637,15827,-1,129,15827,13241
4,125,15827,15952,1,17,15827,5050
4,125,15827,15952,-1,17,15952,13242
4,324,15952,16276,1,87,15952,5051
4,324,15952,16276,-1,87,16276,13243
4,150,16276,16426,1,81,16276,5052
4,150,16276,16426,-1,81,16426,13244
4,170,16426,16596,1,135,16426,5053
4,170,16426,16596,-1,135,16596,13245
4,163,16596,16759,1,112,16596,5054
4,163,16596,16759,-1,112,16759,13246
4,136,16759,16895,1,239,16759,5055
4,136,16759,16895,-1,239,16895,13247
4,78,16895,16973,1,91,16895,5056
4,78,16895,16973,-1,91,16973,13248
4,212,16973,17185,1,179,16973,5057
4,212,16973,17185,-1,179,17185,13249
4,113,17185,17298,1,53,17185,5058
4,113,17185,17298,-1,53,17298,13250
4,97,17298,17395,1,172,17298,5059
4,97,17298,17395,-1,172,17395,13251
4,224,17395,17619,1,90,17395,5060
4,224,17395,17619,-1,90,17619,13252
4,90,17619,17709,1,202,17619,5061
4,90,17619,17709,-1,202,17709,13253
4,110,17709,17819,1,43,17709,5062
4,110,17709,17819,-1,43,17819,13254
4,66,17819,17885,1,64,17819,5063
4,66,17819,17885,-1,64,17885,13255
4,77,17885,17962,1,203,17885,5064
4,77,17885,17962,-1,203,17962,13256
4,272,17962,18234,1,176,17962,5065
4,272,17962,18234,-1,176,18234,13257
4,91,18234,18325,1,6,18234,5066
4,91,18234,18325,-1,6,18325,13258
4,76,18325,18401,1,86,18325,5067
4,76,18325,18401,-1,86,18401,13259
4,152,18401,18553,1,208,18401,5068
4,152,18401,18553,-1,208,18553,13260
4,139,18553,18692,1,101,18553,5069
4,139,18553,18692,-1,101,18692,13261
4,213,18692,18905,1,153,18692,5070
4,213,18692,18905,-1,153,18905,13262
4,33,18905,18938,1,168,18905,5071
4,33,18905,18938,-1,168,18938,13263
4,118,18938,19056,1,227,18938,5072
4,118,18938,19056,-1,227,19056,13264
4,206,19056,19262,1,22,19056,5073
4,206,19056,19262,-1,22,19262,13265
4,133,19262,19395,1,149,19262,5074
4,133,19262,19395,-1,149,19395,13266
4,170,19395,19565,1,107,19395,5075
4,170,19395,19565,-1,107,19565,13267
4,148,19565,19713,1,121,19565,5076
4,148,19565,19713,-1,121,19713,13268
4,175,19713,19888,1,8,19713,5077
4,175,19713,19888,-1,8,19888,13269
4,164,19888,20052,1,225,19888,5078
4,164,19888,20052,-1,225,20052,13270
4,82,20052,20134,1,107,20052,5079
4,82,20052,20134,-1,107,20134,13271
4,176,20134,20310,1,34,20134,5080
4,176,20134,20310,-1,34,20310,13272
4,153,20310,20463,1,218,20310,5081
4,153,20310,20463,-1,218,20463,13273
4,139,20463,20602,1,111,20463,5082
4,139,20463,20602,-1,111,20602,13274
4,158,20602,20760,1,24,20602,5083
4,158,20602,20760,-1,24,20760,13275
4,187,20760,20947,1,49,20760,5084
4,187,20760,20947,-1,49,20947,13276
4,37,20947,20984,1,235,20947,5085
4,37,20947,20984,-1,235,20984,13277
4,248,20984,21232,1,51,20984,5086
4,248,20984,21232,-1,51,21232,13278
4,166,21232,21398,1,142,21232,5087
4,166,21232,21398,-1,142,21398,13279
4,104,21398,21502,1,252,21398,5088
4,104,21398,21502,-1,252,21502,13280
4,180,21502,21682,1,88,21502,5089
4,180,21502,21682,-1,88,21682,13281
4,95,21682,21777,1,98,21682,5090
4,95,21682,21777,-1,98,21777,13282
4,68,21777,21845,1,254,21777,5091
4,68,21777,21845,-1,254,21845,13283
4,108,21845,21953,1,181,21845,5092
4,108,21845,21953,-1,181,21953,13284
4,71,21953,22024,1,70,21953,5093
4,71,21953,22024,-1,70,22024,13285
4,176,22024,22200,1,203,22024,5094
4,176,22024,22200,-1,203,22200,13286
4,82,22200,22282,1,235,22200,5095
4,82,22200,22282,-1,235,22282,13287
4,120,22282,22402,1,105,22282,5096
4,120,22282,22402,-1,105,22402,13288
4,152,22402,22554,1,71,22402,5097
4,152,22402,22554,-1,71,22554,13289
4,100,22554,22654,1,246,22554,5098
4,100,22554,22654,-1,246,22654,13290
4,158,22654,22812,1,237,22654,5099
4,158,22654,22812,-1,237,22812,13291
4,127,22812,22939,1,110,22812,5100
4,127,22812,22939,-1,110,22939,13292
4,112,22939,23051,1,76,22939,5101
4,112,22939,23051,-1,76,23051,13293
4,131,23051,23182,1,82,23051,5102
4,131,23051,23182,-1,82,23182,13294
4,92,23182,23274,1,148,23182,5103
4,92,23182,23274,-1,148,23274,13295
4,80,23274,23354,1,129,23274,5104
4,80,23274,23354,-1,129,23354,13296
4,57,23354,23411,1,181,23354,5105
4,57,23354,23411,-1,181,23411,13297
4,149,23411,23560,1,123,23411,5106
4,149,23411,23560,-1,123,23560,13298
4,142,23560,23702,1,18,23560,5107
4,142,23560,23702,-1,18,23702,13299
4,31,23702,23733,1,123,23702,5108
4,31,23702,23733,-1,123,23733,13300
4,155,23733,23888,1,177,23733,5109
4,155,23733,23888,-1,177,23888,13301
4,250,23888,24138,1,139,23888,5110
4,250,23888,24138,-1,139,24138,13302
4,43,24138,24181,1,66,24138,5111
4,43,24138,24181,-1,66,24181,13303
4,166,24181,24347,1,201,24181,5112
4,166,24181,24347,-1,201,24347,13304
4,75,24347,24422,1,17,24347,5113
4,75,24347,24422,-1,17,24422,13305
4,66,24422,24488,1,185,24422,5114
4,66,24422,24488,-1,185,24488,13306
4,34,24488,24522,1,227,24488,5115
4,34,24488,24522,-1,227,24522,13307
4,78,24522,24600,1,59,24522,5116
4,78,24522,24600,-1,59,24600,13308
4,108,24600,24708,1,50,24600,5117
4,108,24600,24708,-1,50,24708,13309
4,48,24708,24756,1,187,24708,5118
4,48,24708,24756,-1,187,24756,13310
4,129,24756,24885,1,114,24756,5119
4,129,24756,24885,-1,114,24885,13311
4,142,24885,25027,1,132,24885,5120
4,142,24885,25027,-1,132,25027,13312
4,83,25027,25110,1,88,25027,5121
4,83,25027,25110,-1,88,25110,13313
4,159,25110,25269,1,126,25110,5122
4,159,25110,25269,-1,126,25269,13314
4,55,25269,25324,1,17,25269,5123
4,55,25269,25324,-1,17,25324,13315
4,167,25324,25491,1,32,25324,5124
4,167,25324,25491,-1,32,25491,13316
4,107,25491,25598,1,175,25491,5125
4,107,25491,25598,-1,175,25598,13317
4,53,25598,25651,1,9,25598,5126
4,53,25598,25651,-1,9,25651,13318
4,108,25651,25759,1,223,25651,5127
4,108,25651,25759,-1,223,25759,13319
4,107,25759,25866,1,19,25759,5128
4,107,25759,25866,-1,19,25866,13320
4,153,25866,26019,1,127,25866,5129
4,153,25866,26019,-1,127,26019,13321
4,79,26019,26098,1,32,26019,5130
4,79,26019,26098,-1,32,26098,13322
4,71,26098,26169,1,58,26098,5131
4,71,26098,26169,-1,58,26169,13323
4,64,26169,26233,1,37,26169,5132
4,64,26169,26233,-1,37,26233,13324
4,92,26233,26325,1,239,26233,5133
4,92,26233,26325,-1,239,26325,13325
4,220,26325,26545,1,141,26325,5134
4,220,26325,26545,-1,141,26545,13326
4,56,26545,26601,1,46,26545,5135
4,56,26545,26601,-1,46,26601,13327
4,105,26601,26706,1,146,26601,5136
4,105,26601,26706,-1,146,26706,13328
4,181,26706,26887,1,253,26706,5137
4,181,26706,26887,-1,253,26887,13329
4,210,26887,27097,1,220,26887,5138
4,210,26887,27097,-1,220,27097,13330
4,93,27097,27190,1,178,27097,5139
4,93,27097,27190,-1,178,27190,13331
4,166,27190,27356,1,99,27190,5140
4,166,27190,27356,-1,99,27356,13332
4,70,27356,27426,1,60,27356,5141
4,70,27356,27426,-1,60,27426,13333
4,89,27426,27515,1,225,27426,5142
4,89,27426,27515,-1,225,27515,13334
4,190,27515,27705,1,146,27515,5143
4,190,27515,27705,-1,146,27705,13335
4,151,27705,27856,1,217,27705,5144
4,151,27705,27856,-1,217,27856,13336
4,91,27856,27947,1,216,27856,5145
4,91,27856,27947,-1,216,27947,13337
4,142,27947,28089,1,207,27947,5146
4,142,27947,28089,-1,207,28089,13338
4,108,28089,28197,1,235,28089,5147
4,108,28089,28197,-1,235,28197,13339
4,23,28197,28220,1,53,28197,5148
4,23,28197,28220,-1,53,28220,13340
4,38,28220,28258,1,104,28220,5149
4,38,28220,28258,-1,104,28258,13341
4,87,28258,28345,1,180,28258,5150
4,87,28258,28345,-1,180,28345,13342
4,92,28345,28437,1,234,28345,5151
4,92,28345,28437,-1,234,28437,13343
4,57,28437,28494,1,143,28437,5152
4,57,28437,28494,-1,143,28494,13344
4,156,28494,28650,1,210,28494,5153
4,156,28494,28650,-1,210,28650,13345
4,76,28650,28726,1,234,28650,5154
4,76,28650,28726,-1,234,28726,13346
4,208,28726,28934,1,220,28726,5155
4,208,28726,28934,-1,220,28934,13347
4,146,28934,29080,1,249,28934,5156
4,146,28934,29080,-1,249,29080,13348
4,113,29080,29193,1,24,29080,5157
4,113,29080,29193,-1,24,29193,13349
4,93,29193,29286,1,145,29193,5158
4,93,29193,29286,-1,145,29286,13350
4,177,29286,29463,1,120,29286,5159
4,177,29286,29463,-1,120,29463,13351
4,204,29463,29667,1,154,29463,5160
4,204,29463,29667,-1,154,29667,13352
4,83,29667,29750,1,136,29667,5161
4,83,29667,29750,-1,136,29750,13353
4,88,29750,29838,1,135,29750,5162
4,88,29750,29838,-1,135,29838,13354
4,44,29838,29882,1,149,29838,5163
4,44,29838,29882,-1,149,29882,13355
4,105,29882,29987,1,40,29882,5164
4,105,29882,29987,-1,40,29987,13356
4,172,29987,30159,1,187,29987,5165
4,172,29987,30159,-1,187,30159,13357
4,80,30159,30239,1,47,30159,5166
4,80,30159,30239,-1,47,30239,13358
4,81,30239,30320,1,34,30239,5167
4,81,30239,30320,-1,34,30320,13359
4,129,30320,30449,1,111,30320,5168
4,129,30320,30449,-1,111,30449,13360
4,25,30449,30474,1,120,30449,5169
4,25,30449,30474,-1,120,30474,13361
5,125,0,125,1,69,0,501
5,125,0,125,-1,69,125,8693
5,24,125,149,1,94,125,502
5,24,125,149,-1,94,149,8694
5,58,149,207,1,256,149,503
5,58,149,207,-1,256,207,8695
5,40,207,247,1,112,207,504
5,40,207,247,-1,112,247,8696
5,43,247,290,1,97,247,505
5,43,247,290,-1,97,290,8697
5,233,290,523,1,199,290,506
5,233,290,523,-1,199,523,8698
5,119,523,642,1,25,523,507
5,119,523,642,-1,25,642,8699
5,128,642,770,1,256,642,508
5,128,642,770,-1,256,770,8700
5,171,770,941,1,88,770,509
5,171,770,941,-1,88,941,8701
5,76,941,1017,1,121,941,510
5,76,941,1017,-1,121,1017,8702
5,87,1017,1104,1,39,1017,511
5,87,1017,1104,-1,39,1104,8703
5,160,1104,1264,1,169,1104,512
5,160,1104,1264,-1,169,1264,8704
5,122,1264,1386,1,245,1264,513
5,122,1264,1386,-1,245,1386,8705
5,223,1386,1609,1,188,1386,514
5,223,1386,1609,-1,188,1609,8706
5,102,1609,1711,1,15,1609,515
5,102,1609,1711,-1,15,1711,8707
5,80,1711,1791,1,21,1711,516
5,80,1711,1791,-1,21,1791,8708
5,110,1791,1901,1,120,1791,517
5,110,1791,1901,-1,120,1901,8709
5,113,1901,2014,1,197,1901,518
5,113,1901,2014,-1,197,2014,8710
5,111,2014,2125,1,57,2014,519
5,111,2014,2125,-1,57,2125,8711
5,317,2125,2442,1,251,2125,520
5,317,2125,2442,-1,251,2442,8712
5,197,2442,2639,1,140,2442,521
5,197,2442,2639,-1,140,2639,8713
5,169,2639,2808,1,31,2639,522
5,169,2639,2808,-1,31,2808,8714
5,285,2808,3093,1,170,2808,523
5,285,2808,3093,-1,170,3093,8715
5,80,3093,3173,1,24,3093,524
5,80,3093,3173,-1,24,3173,8716
5,224,3173,3397,1,207,3173,525
5,224,3173,3397,-1,207,3397,8717
5,60,3397,3457,1,249,3397,526
5,60,3397,3457,-1,249,3457,8718
5,138,3457,3595,1,225,3457,527
5,138,3457,3595,-1,225,3595,8719
5,119,3595,3714,1,247,3595,528
5,119,3595,3714,-1,247,3714,8720
5,97,3714,3811,1,195,3714,529
5,97,3714,3811,-1,195,3811,8721
5,48,3811,3859,1,56,3811,530
5,48,3811,3859,-1,56,3859,8722
5,56,3859,3915,1,103,3859,531
5,56,3859,3915,-1,103,3915,8723
5,204,3915,4119,1,235,3915,532
5,204,3915,4119,-1,235,4119,8724
5,200,4119,4319,1,35,4119,533
5,200,4119,4319,-1,35,4319,8725
5,96,4319,4415,1,228,4319,534
5,96,4319,4415,-1,228,4415,8726
5,84,4415,4499,1,74,4415,535
5,84,4415,4499,-1,74,4499,8727
5,184,4499,4683,1,77,4499,536
5,184,4499,4683,-1,77,4683,8728
5,194,4683,4877,1,123,4683,537
5,194,4683,4877,-1,123,4877,8729
5,151,4877,5028,1,44,4877,538
5,151,4877,5028,-1,44,5028,8730
5,150,5028,5178,1,77,5028,539
5,150,5028,5178,-1,77,5178,8731
5,56,5178,5234,1,61,5178,540
5,56,5178,5234,-1,61,5234,8732
5,149,5234,5383,1,47,5234,541
5,149,5234,5383,-1,47,5383,8733
5,93,5383,5476,1,210,5383,542
5,93,5383,5476,-1,210,5476,8734
5,223,5476,5699,1,140,5476,543
5,223,5476,5699,-1,140,5699,8735
5,71,5699,5770,1,89,5699,544
5,71,5699,5770,-1,89,5770,8736
5,68,5770,5838,1,26,5770,545
5,68,5770,5838,-1,26,5838,8737
5,106,5838,5944,1,30,5838,546
5,106,5838,5944,-1,30,5944,8738
5,137,5944,6081,1,253,5944,547
5,137,5944,6081,-1,253,6081,8739
5,69,6081,6150,1,244,6081,548
5,69,6081,6150,-1,244,6150,8740
5,119,6150,6269,1,2,6150,549
5,119,6150,6269,-1,2,6269,8741
5,102,6269,6371,1,198,6269,550
5,102,6269,6371,-1,198,6371,8742
5,165,6371,6536,1,28,6371,551
5,165,6371,6536,-1,28,6536,8743
5,49,6536,6585,1,41,6536,552
5,49,6536,6585,-1,41,6585,8744
5,126,6585,6711,1,205,6585,553
5,126,6585,6711,-1,205,6711,8745
5,94,6711,6805,1,3,6711,554
5,94,6711,6805,-1,3,6805,8746
5,110,6805,6915,1,197,6805,555
5,110,6805,6915,-1,197,6915,8747
5,97,6915,7012,1,254,6915,556
5,97,6915,7012,-1,254,7012,8748
5,124,7012,7136,1,203,7012,557
5,124,7012,7136,-1,203,7136,8749
5,93,7136,7229,1,20,7136,558
5,93,7136,7229,-1,20,7229,8750
5,121,7229,7350,1,90,7229,559
5,121,7229,7350,-1,90,7350,8751
5,17,7350,7367,1,92,7350,560
5,17,7350,7367,-1,92,7367,8752
5,213,7367,7580,1,35,7367,561
5,213,7367,7580,-1,35,7580,8753
5,136,7580,7716,1,77,7580,562
5,136,7580,7716,-1,77,7716,8754
5,181,7716,7897,1,173,7716,563
5,181,7716,7897,-1,173,7897,8755
5,80,7897,7977,1,39,7897,564
5,80,7897,7977,-1,39,7977,8756
5,124,7977,8101,1,131,7977,565
5,124,7977,8101,-1,131,8101,8757
5,129,8101,8230,1,163,8101,566
5,129,8101,8230,-1,163,8230,8758
5,162,8230,8392,1,177,8230,567
5,162,8230,8392,-1,177,8392,8759
5,197,8392,8589,1,218,8392,568
5,197,8392,8589,-1,218,8589,8760
5,119,8589,8708,1,17,8589,569
5,119,8589,8708,-1,17,8708,8761
5,76,8708,8784,1,250,8708,570
5,76,8708,8784,-1,250,8784,8762
5,101,8784,8885,1,24,8784,571
5,101,8784,8885,-1,24,8885,8763
5,45,8885,8930,1,256,8885,572
5,45,8885,8930,-1,256,8930,8764
5,172,8930,9102,1,183,8930,573
5,172,8930,9102,-1,183,9102,8765
5,138,9102,9240,1,256,9102,574
5,138,9102,9240,-1,256,9240,8766
5,144,9240,9384,1,52,9240,575
5,144,9240,9384,-1,52,9384,8767
5,238,9384,9622,1,252,9384,576
5,238,9384,9622,-1,252,9622,8768
5,184,9622,9806,1,175,9622,577
5,184,9622,9806,-1,175,9806,8769
5,122,9806,9928,1,137,9806,578
5,122,9806,9928,-1,137,9928,8770
5,65,9928,9993,1,198,9928,579
5,65,9928,9993,-1,198,9993,8771
5,84,9993,10077,1,14,9993,580
5,84,9993,10077,-1,14,10077,8772
5,237,10077,10314,1,235,10077,581
5,237,10077,10314,-1,235,10314,8773
5,115,10314,10429,1,36,10314,582
5,115,10314,10429,-1,36,10429,8774
5,139,10429,10568,1,79,10429,583
5,139,10429,10568,-1,79,10568,8775
5,194,10568,10762,1,36,10568,584
5,194,10568,10762,-1,36,10762,8776
5,86,10762,10848,1,141,10762,585
5,86,10762,10848,-1,141,10848,8777
5,152,10848,11000,1,241,10848,586
5,152,10848,11000,-1,241,11000,8778
5,169,11000,11169,1,62,11000,587
5,169,11000,11169,-1,62,11169,8779
5,177,11169,11346,1,190,11169,588
5,177,11169,11346,-1,190,11346,8780
5,297,11346,11643,1,245,11346,589
5,297,11346,11643,-1,245,11643,8781
5,44,11643,11687,1,95,11643,590
5,44,11643,11687,-1,95,11687,8782
5,214,11687,11901,1,61,11687,591
5,214,11687,11901,-1,61,11901,8783
5,256,11901,12157,1,34,11901,592
5,256,11901,12157,-1,34,12157,8784
5,103,12157,12260,1,1,12157,593
5,103,12157,12260,-1,1,12260,8785
5,65,12260,12325,1,126,12260,594
5,65,12260,12325,-1,126,12325,8786
5,105,12325,12430,1,119,12325,595
5,105,12325,12430,-1,119,12430,8787
5,174,12430,12604,1,33,12430,596
5,174,12430,12604,-1,33,12604,8788
5,225,12604,12829,1,231,12604,597
5,225,12604,12829,-1,231,12829,8789
5,119,12829,12948,1,101,12829,598
5,119,12829,12948,-1,101,12948,8790
5,121,12948,13069,1,232,12948,599
5,121,12948,13069,-1,232,13069,8791
5,69,13069,13138,1,38,13069,600
5,69,13069,13138,-1,38,13138,8792
5,89,13138,13227,1,239,13138,601
5,89,13138,13227,-1,239,13227,8793
5,196,13227,13423,1,160,13227,602
5,196,13227,13423,-1,160,13423,8794
5,86,13423,13509,1,39,13423,603
5,86,13423,13509,-1,39,13509,8795
5,34,13509,13543,1,146,13509,604
5,34,13509,13543,-1,146,13543,8796
5,146,13543,13689,1,56,13543,605
5,146,13543,13689,-1,56,13689,8797
5,338,13689,14027,1,155,13689,606
5,338,13689,14027,-1,155,14027,8798
5,71,14027,14098,1,197,14027,607
5,71,14027,14098,-1,197,14098,8799
5,125,14098,14223,1,102,14098,608
5,125,14098,14223,-1,102,14223,8800
5,93,14223,14316,1,253,14223,609
5,93,14223,14316,-1,253,14316,8801
5,149,14316,14465,1,8,14316,610
5,149,14316,14465,-1,8,14465,8802
5,201,14465,14666,1,185,14465,611
5,201,14465,14666,-1,185,14666,8803
5,99,14666,14765,1,251,14666,612
5,99,14666,14765,-1,251,14765,8804
5,102,14765,14867,1,62,14765,613
5,102,14765,14867,-1,62,14867,8805
5,107,14867,14974,1,66,14867,614
5,107,14867,14974,-1,66,14974,8806
5,82,14974,15056,1,207,14974,615
5,82,14974,15056,-1,207,15056,8807
5,162,15056,15218,1,255,15056,616
5,162,15056,15218,-1,255,15218,8808
5,70,15218,15288,1,211,15218,617
5,70,15218,15288,-1,211,15288,8809
5,135,15288,15423,1,60,15288,618
5,135,15288,15423,-1,60,15423,8810
5,148,15423,15571,1,105,15423,619
5,148,15423,15571,-1,105,15571,8811
5,83,15571,15654,1,98,15571,620
5,83,15571,15654,-1,98,15654,8812
5,164,15654,15818,1,225,15654,621
5,164,15654,15818,-1,225,15818,8813
5,79,15818,15897,1,109,15818,622
5,79,15818,15897,-1,109,15897,8814
5,186,15897,16083,1,177,15897,623
5,186,15897,16083,-1,177,16083,8815
5,101,16083,16184,1,204,16083,624
5,101,16083,16184,-1,204,16184,8816
5,205,16184,16389,1,231,16184,625
5,205,16184,16389,-1,231,16389,8817
5,118,16389,16507,1,89,16389,626
5,118,16389,16507,-1,89,16507,8818
5,89,16507,16596,1,56,16507,627
5,89,16507,16596,-1,56,16596,8819
5,82,16596,16678,1,2,16596,628
5,82,16596,16678,-1,2,16678,8820
5,60,16678,16738,1,17,16678,629
5,60,16678,16738,-1,17,16738,8821
5,154,16738,16892,1,211,16738,630
5,154,16738,16892,-1,211,16892,8822
5,315,16892,17207,1,200,16892,631
5,315,16892,17207,-1,200,17207,8823
5,96,17207,17303,1,253,17207,632
5,96,17207,17303,-1,253,17303,8824
5,225,17303,17528,1,161,17303,633
5,225,17303,17528,-1,161,17528,8825
5,144,17528,17672,1,48,17528,634
5,144,17528,17672,-1,48,17672,8826
5,170,17672,17842,1,153,17672,635
5,170,17672,17842,-1,153,17842,8827
5,110,17842,17952,1,91,17842,636
5,110,17842,17952,-1,91,17952,8828
5,183,17952,18135,1,111,17952,637
5,183,17952,18135,-1,111,18135,8829
5,63,18135,18198,1,98,18135,638
5,63,18135,18198,-1,98,18198,8830
5,221,18198,18419,1,11,18198,639
5,221,18198,18419,-1,11,18419,8831
5,124,18419,18543,1,68,18419,640
5,124,18419,18543,-1,68,18543,8832
5,61,18543,18604,1,139,18543,641
5,61,18543,18604,-1,139,18604,8833
5,140,18604,18744,1,122,18604,642
5,140,18604,18744,-1,122,18744,8834
5,87,18744,18831,1,25,18744,643
5,87,18744,18831,-1,25,18831,8835
5,107,18831,18938,1,184,18831,644
5,107,18831,18938,-1,184,18938,8836
5,84,18938,19022,1,14,18938,645
5,84,18938,19022,-1,14,19022,8837
5,179,19022,19201,1,27,19022,646
5,179,19022,19201,-1,27,19201,8838
5,150,19201,19351,1,124,19201,647
5,150,19201,19351,-1,124,19351,8839
5,106,19351,19457,1,107,19351,648
5,106,19351,19457,-1,107,19457,8840
5,127,19457,19584,1,221,19457,649
5,127,19457,19584,-1,221,19584,8841
5,175,19584,19759,1,62,19584,650
5,175,19584,19759,-1,62,19759,8842
5,91,19759,19850,1,245,19759,651
5,91,19759,19850,-1,245,19850,8843
5,97,19850,19947,1,108,19850,652
5,97,19850,19947,-1,108,19947,8844
5,166,19947,20113,1,60,19947,653
5,166,19947,20113,-1,60,20113,8845
5,297,20113,20410,1,34,20113,654
5,297,20113,20410,-1,34,20410,8846
5,225,20410,20635,1,195,20410,655
5,225,20410,20635,-1,195,20635,8847
5,259,20635,20894,1,253,20635,656
5,259,20635,20894,-1,253,20894,8848
5,76,20894,20970,1,207,20894,657
5,76,20894,20970,-1,207,20970,8849
5,151,20970,21121,1,112,20970,658
5,151,20970,21121,-1,112,21121,8850
5,172,21121,21293,1,96,21121,659
5,172,21121,21293,-1,96,21293,8851
5,176,21293,21469,1,104,21293,660
5,176,21293,21469,-1,104,21469,8852
5,160,21469,21629,1,51,21469,661
5,160,21469,21629,-1,51,21629,8853
5,24,21629,21653,1,179,21629,662
5,24,21629,21653,-1,179,21653,8854
5,26,21653,21679,1,24,21653,663
5,26,21653,21679,-1,24,21679,8855
5,102,21679,21781,1,104,21679,664
5,102,21679,21781,-1,104,21781,8856
5,120,21781,21901,1,113,21781,665
5,120,21781,21901,-1,113,21901,8857
5,166,21901,22067,1,112,21901,666
5,166,21901,22067,-1,112,22067,8858
5,137,22067,22204,1,210,22067,667
5,137,22067,22204,-1,210,22204,8859
5,104,22204,22308,1,146,22204,668
5,104,22204,22308,-1,146,22308,8860
5,108,22308,22416,1,205,22308,669
5,108,22308,22416,-1,205,22416,8861
5,162,22416,22578,1,212,22416,670
5,162,22416,22578,-1,212,22578,8862
5,121,22578,22699,1,184,22578,671
5,121,22578,22699,-1,184,22699,8863
5,122,22699,22821,1,46,22699,672
5,122,22699,22821,-1,46,22821,8864
5,163,22821,22984,1,172,22821,673
5,163,22821,22984,-1,172,22984,8865
5,88,22984,23072,1,219,22984,674
5,88,22984,23072,-1,219,23072,8866
5,198,23072,23270,1,150,23072,675
5,198,23072,23270,-1,150,23270,8867
5,219,23270,23489,1,64,23270,676
5,219,23270,23489,-1,64,23489,8868
5,101,23489,23590,1,247,23489,677
5,101,23489,23590,-1,247,23590,8869
5,110,23590,23700,1,197,23590,678
5,110,23590,23700,-1,197,23700,8870
5,91,23700,23791,1,148,23700,679
5,91,23700,23791,-1,148,23791,8871
5,151,23791,23942,1,183,23791,680
5,151,23791,23942,-1,183,23942,8872
5,82,23942,24024,1,141,23942,681
5,82,23942,24024,-1,141,24024,8873
5,203,24024,24227,1,245,24024,682
5,203,24024,24227,-1,245,24227,8874
5,84,24227,24311,1,73,24227,683
5,84,24227,24311,-1,73,24311,8875
5,93,24311,24404,1,201,24311,684
5,93,24311,24404,-1,201,24404,8876
5,39,24404,24443,1,231,24404,685
5,39,24404,24443,-1,231,24443,8877
5,189,24443,24632,1,91,24443,686
5,189,24443,24632,-1,91,24632,8878
5,38,24632,24670,1,173,24632,687
5,38,24632,24670,-1,173,24670,8879
5,235,24670,24905,1,159,24670,688
5,235,24670,24905,-1,159,24905,8880
5,98,24905,25003,1,92,24905,689
5,98,24905,25003,-1,92,25003,8881
5,87,25003,25090,1,236,25003,690
5,87,25003,25090,-1,236,25090,8882
5,236,25090,25326,1,87,25090,691
5,236,25090,25326,-1,87,25326,8883
5,106,25326,25432,1,59,25326,692
5,106,25326,25432,-1,59,25432,8884
5,161,25432,25593,1,6,25432,693
5,161,25432,25593,-1,6,25593,8885
5,59,25593,25652,1,255,25593,694
5,59,25593,25652,-1,255,25652,8886
5,50,25652,25702,1,209,25652,695
5,50,25652,25702,-1,209,25702,8887
5,195,25702,25897,1,143,25702,696
5,195,25702,25897,-1,143,25897,8888
5,142,25897,26039,1,60,25897,697
5,142,25897,26039,-1,60,26039,8889
5,141,26039,26180,1,138,26039,698
5,141,26039,26180,-1,138,26180,8890
5,109,26180,26289,1,149,26180,699
5,109,26180,26289,-1,149,26289,8891
5,114,26289,26403,1,178,26289,700
5,114,26289,26403,-1,178,26403,8892
5,167,26403,26570,1,230,26403,701
5,167,26403,26570,-1,230,26570,8893
5,43,26570,26613,1,237,26570,702
5,43,26570,26613,-1,237,26613,8894
5,150,26613,26763,1,192,26613,703
5,150,26613,26763,-1,192,26763,8895
5,293,26763,27056,1,77,26763,704
5,293,26763,27056,-1,77,27056,8896
5,179,27056,27235,1,199,27056,705
5,179,27056,27235,-1,199,27235,8897
5,129,27235,27364,1,92,27235,706
5,129,27235,27364,-1,92,27364,8898
5,60,27364,27424,1,51,27364,707
5,60,27364,27424,-1,51,27424,8899
5,80,27424,27504,1,52,27424,708
5,80,27424,27504,-1,52,27504,8900
5,53,27504,27557,1,138,27504,709
5,53,27504,27557,-1,138,27557,8901
5,197,27557,27754,1,119,27557,710
5,197,27557,27754,-1,119,27754,8902
5,70,27754,27824,1,12,27754,711
5,70,27754,27824,-1,12,27824,8903
5,189,27824,28013,1,118,27824,712
5,189,27824,28013,-1,118,28013,8904
5,44,28013,28057,1,194,28013,713
5,44,28013,28057,-1,194,28057,8905
5,115,28057,28172,1,253,28057,714
5,115,28057,28172,-1,253,28172,8906
5,85,28172,28257,1,35,28172,715
5,85,28172,28257,-1,35,28257,8907
5,138,28257,28395,1,140,28257,716
5,138,28257,28395,-1,140,28395,8908
5,165,28395,28560,1,181,28395,717
5,165,28395,28560,-1,181,28560,8909
6,98,0,98,1,180,0,992
6,98,0,98,-1,180,98,9184
6,74,98,172,1,23,98,993
6,74,98,172,-1,23,172,9185
6,141,172,313,1,217,172,994
6,141,172,313,-1,217,313,9186
6,254,313,567,1,90,313,995
6,254,313,567,-1,90,567,9187
6,142,567,709,1,147,567,996
6,142,567,709,-1,147,709,9188
6,165,709,874,1,52,709,997
6,165,709,874,-1,52,874,9189
6,219,874,1093,1,254,874,998
6,219,874,1093,-1,254,1093,9190
6,122,1093,1215,1,67,1093,999
6,122,1093,1215,-1,67,1215,9191
6,222,1215,1437,1,192,1215,1000
6,222,1215,1437,-1,192,1437,9192
6,82,1437,1519,1,122,1437,1001
6,82,1437,1519,-1,122,1519,9193
6,157,1519,1676,1,243,1519,1002
6,157,1519,1676,-1,243,1676,9194
6,34,1676,1710,1,174,1676,1003
6,34,1676,1710,-1,174,1710,9195
6,289,1710,1999,1,231,1710,1004
6,289,1710,1999,-1,231,1999,9196
6,94,1999,2093,1,164,1999,1005
6,94,1999,2093,-1,164,2093,9197
6,152,2093,2245,1,169,2093,1006
6,152,2093,2245,-1,169,2245,9198
6,32,2245,2277,1,39,2245,1007
6,32,2245,2277,-1,39,2277,9199
6,110,2277,2387,1,5,2277,1008
6,110,2277,2387,-1,5,2387,9200
6,161,2387,2548,1,245,2387,1009
6,161,2387,2548,-1,245,2548,9201
6,121,2548,2669,1,235,2548,1010
6,121,2548,2669,-1,235,2669,9202
6,61,2669,2730,1,203,2669,1011
6,61,2669,2730,-1,203,2730,9203
6,74,2730,2804,1,210,2730,1012
6,74,2730,2804,-1,210,2804,9204
6,125,2804,2929,1,142,2804,1013
6,125,2804,2929,-1,142,2929,9205
6,46,2929,2975,1,217,2929,1014
6,46,2929,2975,-1,217,2975,9206
6,80,2975,3055,1,32,2975,1015
6,80,2975,3055,-1,32,3055,9207
6,14,3055,3069,1,98,3055,1016
6,14,3055,3069,-1,98,3069,9208
6,89,3069,3158,1,132,3069,1017
6,89,3069,3158,-1,132,3158,9209
6,94,3158,3252,1,5,3158,1018
6,94,3158,3252,-1,5,3252,9210
6,77,3252,3329,1,201,3252,1019
6,77,3252,3329,-1,201,3329,9211
6,118,3329,3447,1,150,3329,1020
6,118,3329,3447,-1,150,3447,9212
6,148,3447,3595,1,155,3447,1021
6,148,3447,3595,-1,155,3595,9213
6,125,3595,3720,1,158,3595,1022
6,125,3595,3720,-1,158,3720,9214
6,370,3720,4090,1,90,3720,1023
6,370,3720,4090,-1,90,4090,9215
6,136,4090,4226,1,112,4090,1024
6,136,4090,4226,-1,112,4226,9216
6,159,4226,4385,1,218,4226,1025
6,159,4226,4385,-1,218,4385,9217
6,110,4385,4495,1,7,4385,1026
6,110,4385,4495,-1,7,4495,9218
6,168,4495,4663,1,23,4495,1027
6,168,4495,4663,-1,23,4663,9219
6,103,4663,4766,1,86,4663,1028
6,103,4663,4766,-1,86,4766,9220
6,235,4766,5001,1,145,4766,1029
6,235,4766,5001,-1,145,5001,9221
6,69,5001,5070,1,112,5001,1030
6,69,5001,5070,-1,112,5070,9222
6,112,5070,5182,1,229,5070,1031
6,112,5070,5182,-1,229,5182,9223
6,108,5182,5290,1,166,5182,1032
6,108,5182,5290,-1,166,5290,9224
6,138,5290,5428,1,227,5290,1033
6,138,5290,5428,-1,227,5428,9225
6,23,5428,5451,1,27,5428,1034
6,23,5428,5451,-1,27,5451,9226
6,97,5451,5548,1,134,5451,1035
6,97,5451,5548,-1,134,5548,9227
6,113,5548,5661,1,43,5548,1036
6,113,5548,5661,-1,43,5661,9228
6,79,5661,5740,1,191,5661,1037
6,79,5661,5740,-1,191,5740,9229
6,105,5740,5845,1,251,5740,1038
6,105,5740,5845,-1,251,5845,9230
6,43,5845,5888,1,15,5845,1039
6,43,5845,5888,-1,15,5888,9231
6,73,5888,5961,1,25,5888,1040
6,73,5888,5961,-1,25,5961,9232
6,56,5961,6017,1,114,5961,1041
6,56,5961,6017,-1,114,6017,9233
6,90,6017,6107,1,249,6017,1042
6,90,6017,6107,-1,249,6107,9234
6,59,6107,6166,1,46,6107,1043
6,59,6107,6166,-1,46,6166,9235
6,38,6166,6204,1,35,6166,1044
6,38,6166,6204,-1,35,6204,9236
6,72,6204,6276,1,45,6204,1045
6,72,6204,6276,-1,45,6276,9237
6,156,6276,6432,1,190,6276,1046
6,156,6276,6432,-1,190,6432,9238
6,123,6432,6555,1,245,6432,1047
6,123,6432,6555,-1,245,6555,9239
6,139,6555,6694,1,122,6555,1048
6,139,6555,6694,-1,122,6694,9240
6,73,6694,6767,1,90,6694,1049
6,73,6694,6767,-1,90,6767,9241
6,77,6767,6844,1,33,6767,1050
6,77,6767,6844,-1,33,6844,9242
6,128,6844,6972,1,176,6844,1051
6,128,6844,6972,-1,176,6972,9243
6,23,6972,6995,1,104,6972,1052
6,23,6972,6995,-1,104,6995,9244
6,109,6995,7104,1,7,6995,1053
6,109,6995,7104,-1,7,7104,9245
6,102,7104,7206,1,17,7104,1054
6,102,7104,7206,-1,17,7206,9246
6,221,7206,7427,1,240,7206,1055
6,221,7206,7427,-1,240,7427,9247
6,108,7427,7535,1,25,7427,1056
6,108,7427,7535,-1,25,7535,9248
6,199,7535,7734,1,12,7535,1057
6,199,7535,7734,-1,12,7734,9249
6,90,7734,7824,1,62,7734,1058
6,90,7734,7824,-1,62,7824,9250
6,80,7824,7904,1,153,7824,1059
6,80,7824,7904,-1,153,7904,9251
6,69,7904,7973,1,97,7904,1060
6,69,7904,7973,-1,97,7973,9252
6,228,7973,8201,1,167,7973,1061
6,228,7973,8201,-1,167,8201,9253
6,222,8201,8423,1,96,8201,1062
6,222,8201,8423,-1,96,8423,9254
6,120,8423,8543,1,63,8423,1063
6,120,8423,8543,-1,63,8543,9255
6,122,8543,8665,1,256,8543,1064
6,122,8543,8665,-1,256,8665,9256
6,79,8665,8744,1,213,8665,1065
6,79,8665,8744,-1,213,8744,9257
6,76,8744,8820,1,119,8744,1066
6,76,8744,8820,-1,119,8820,9258
6,113,8820,8933,1,211,8820,1067
6,113,8820,8933,-1,211,8933,9259
6,267,8933,9200,1,30,8933,1068
6,267,8933,9200,-1,30,9200,9260
6,29,9200,9229,1,189,9200,1069
6,29,9200,9229,-1,189,9229,9261
6,181,9229,9410,1,90,9229,1070
6,181,9229,9410,-1,90,9410,9262
6,97,9410,9507,1,185,9410,1071
6,97,9410,9507,-1,185,9507,9263
6,164,9507,9671,1,225,9507,1072
6,164,9507,9671,-1,225,9671,9264
6,229,9671,9900,1,42,9671,1073
6,229,9671,9900,-1,42,9900,9265
6,195,9900,10095,1,68,9900,1074
6,195,9900,10095,-1,68,10095,9266
6,86,10095,10181,1,104,10095,1075
6,86,10095,10181,-1,104,10181,9267
6,124,10181,10305,1,170,10181,1076
6,124,10181,10305,-1,170,10305,9268
6,111,10305,10416,1,39,10305,1077
6,111,10305,10416,-1,39,10416,9269
6,86,10416,10502,1,49,10416,1078
6,86,10416,10502,-1,49,10502,9270
6,74,10502,10576,1,182,10502,1079
6,74,10502,10576,-1,182,10576,9271
6,84,10576,10660,1,236,10576,1080
6,84,10576,10660,-1,236,10660,9272
6,78,10660,10738,1,169,10660,1081
6,78,10660,10738,-1,169,10738,9273
6,33,10738,10771,1,173,10738,1082
6,33,10738,10771,-1,173,10771,9274
6,77,10771,10848,1,96,10771,1083
6,77,10771,10848,-1,96,10848,9275
6,194,10848,11042,1,252,10848,1084
6,194,10848,11042,-1,252,11042,9276
6,102,11042,11144,1,29,11042,1085
6,102,11042,11144,-1,29,11144,9277
6,101,11144,11245,1,134,11144,1086
6,101,11144,11245,-1,134,11245,9278
6,94,11245,11339,1,22,11245,1087
6,94,11245,11339,-1,22,11339,9279
6,35,11339,11374,1,29,11339,1088
6,35,11339,11374,-1,29,11374,9280
6,94,11374,11468,1,5,11374,1089
6,94,11374,11468,-1,5,11468,9281
6,136,11468,11604,1,30,11468,1090
6,136,11468,11604,-1,30,11604,9282
6,107,11604,11711,1,118,11604,1091
6,107,11604,11711,-1,118,11711,9283
6,236,11711,11947,1,191,11711,1092
6,236,11711,11947,-1,191,11947,9284
6,206,11947,12153,1,98,11947,1093
6,206,11947,12153,-1,98,12153,9285
6,185,12153,12338,1,113,12153,1094
6,185,12153,12338,-1,113,12338,9286
6,133,12338,12471,1,72,12338,1095
6,133,12338,12471,-1,72,12471,9287
6,213,12471,12684,1,123,12471,1096
6,213,12471,12684,-1,123,12684,9288
6,201,12684,12885,1,148,12684,1097
6,201,12684,12885,-1,148,12885,9289
6,93,12885,12978,1,17,12885,1098
6,93,12885,12978,-1,17,12978,9290
6,93,12978,13071,1,252,12978,1099
6,93,12978,13071,-1,252,13071,9291
6,92,13071,13163,1,69,13071,1100
6,92,13071,13163,-1,69,13163,9292
6,178,13163,13341,1,151,13163,1101
6,178,13163,13341,-1,151,13341,9293
6,160,13341,13501,1,205,13341,1102
6,160,13341,13501,-1,205,13501,9294
6,89,13501,13590,1,132,13501,1103
6,89,13501,13590,-1,132,13590,9295
6,190,13590,13780,1,167,13590,1104
6,190,13590,13780,-1,167,13780,9296
6,157,13780,13937,1,173,13780,1105
6,157,13780,13937,-1,173,13937,9297
6,115,13937,14052,1,174,13937,1106
6,115,13937,14052,-1,174,14052,9298
6,73,14052,14125,1,148,14052,1107
6,73,14052,14125,-1,148,14125,9299
6,236,14125,14361,1,252,14125,1108
6,236,14125,14361,-1,252,14361,9300
6,111,14361,14472,1,104,14361,1109
6,111,14361,14472,-1,104,14472,9301
6,103,14472,14575,1,241,14472,1110
6,103,14472,14575,-1,241,14575,9302
6,96,14575,14671,1,173,14575,1111
6,96,14575,14671,-1,173,14671,9303
6,88,14671,14759,1,42,14671,1112
6,88,14671,14759,-1,42,14759,9304
6,121,14759,14880,1,46,14759,1113
6,121,14759,14880,-1,46,14880,9305
6,94,14880,14974,1,53,14880,1114
6,94,14880,14974,-1,53,14974,9306
6,83,14974,15057,1,115,14974,1115
6,83,14974,15057,-1,115,15057,9307
6,171,15057,15228,1,75,15057,1116
6,171,15057,15228,-1,75,15228,9308
6,121,15228,15349,1,111,15228,1117
6,121,15228,15349,-1,111,15349,9309
6,157,15349,15506,1,102,15349,1118
6,157,15349,15506,-1,102,15506,9310
6,152,15506,15658,1,69,15506,1119
6,152,15506,15658,-1,69,15658,9311
6,82,15658,15740,1,43,15658,1120
6,82,15658,15740,-1,43,15740,9312
6,99,15740,15839,1,173,15740,1121
6,99,15740,15839,-1,173,15839,9313
6,198,15839,16037,1,197,15839,1122
6,198,15839,16037,-1,197,16037,9314
6,121,16037,16158,1,215,16037,1123
6,121,16037,16158,-1,215,16158,9315
6,71,16158,16229,1,88,16158,1124
6,71,16158,16229,-1,88,16229,9316
6,100,16229,16329,1,219,16229,1125
6,100,16229,16329,-1,219,16329,9317
6,286,16329,16615,1,36,16329,1126
6,286,16329,16615,-1,36,16615,9318
6,130,16615,16745,1,35,16615,1127
6,130,16615,16745,-1,35,16745,9319
6,174,16745,16919,1,22,16745,1128
6,174,16745,16919,-1,22,16919,9320
6,267,16919,17186,1,81,16919,1129
6,267,16919,17186,-1,81,17186,9321
6,128,17186,17314,1,212,17186,1130
6,128,17186,17314,-1,212,17314,9322
6,38,17314,17352,1,29,17314,1131
6,38,17314,17352,-1,29,17352,9323
6,188,17352,17540,1,198,17352,1132
6,188,17352,17540,-1,198,17540,9324
6,177,17540,17717,1,91,17540,1133
6,177,17540,17717,-1,91,17717,9325
6,124,17717,17841,1,40,17717,1134
6,124,17717,17841,-1,40,17841,9326
6,197,17841,18038,1,12,17841,1135
6,197,17841,18038,-1,12,18038,9327
6,89,18038,18127,1,161,18038,1136
6,89,18038,18127,-1,161,18127,9328
6,59,18127,18186,1,63,18127,1137
6,59,18127,18186,-1,63,18186,9329
6,117,18186,18303,1,26,18186,1138
6,117,18186,18303,-1,26,18303,9330
6,28,18303,18331,1,107,18303,1139
6,28,18303,18331,-1,107,18331,9331
6,133,18331,18464,1,118,18331,1140
6,133,18331,18464,-1,118,18464,9332
6,70,18464,18534,1,89,18464,1141
6,70,18464,18534,-1,89,18534,9333
6,159,18534,18693,1,178,18534,1142
6,159,18534,18693,-1,178,18693,9334
6,168,18693,18861,1,20,18693,1143
6,168,18693,18861,-1,20,18861,9335
6,92,18861,18953,1,91,18861,1144
6,92,18861,18953,-1,91,18953,9336
6,22,18953,18975,1,49,18953,1145
6,22,18953,18975,-1,49,18975,9337
6,105,18975,19080,1,148,18975,1146
6,105,18975,19080,-1,148,19080,9338
6,29,19080,19109,1,9,19080,1147
6,29,19080,19109,-1,9,19109,9339
6,103,19109,19212,1,145,19109,1148
6,103,19109,19212,-1,145,19212,9340
6,88,19212,19300,1,133,19212,1149
6,88,19212,19300,-1,133,19300,9341
6,107,19300,19407,1,102,19300,1150
6,107,19300,19407,-1,102,19407,9342
6,166,19407,19573,1,122,19407,1151
6,166,19407,19573,-1,122,19573,9343
6,23,19573,19596,1,131,19573,1152
6,23,19573,19596,-1,131,19596,9344
6,65,19596,19661,1,140,19596,1153
6,65,19596,19661,-1,140,19661,9345
6,78,19661,19739,1,238,19661,1154
6,78,19661,19739,-1,238,19739,9346
6,93,19739,19832,1,133,19739,1155
6,93,19739,19832,-1,133,19832,9347
6,96,19832,19928,1,184,19832,1156
6,96,19832,19928,-1,184,19928,9348
6,188,19928,20116,1,51,19928,1157
6,188,19928,20116,-1,51,20116,9349
6,68,20116,20184,1,29,20116,1158
6,68,20116,20184,-1,29,20184,9350
6,187,20184,20371,1,107,20184,1159
6,187,20184,20371,-1,107,20371,9351
6,50,20371,20421,1,18,20371,1160
6,50,20371,20421,-1,18,20421,9352
6,204,20421,20625,1,119,20421,1161
6,204,20421,20625,-1,119,20625,9353
6,125,20625,20750,1,83,20625,1162
6,125,20625,20750,-1,83,20750,9354
6,292,20750,21042,1,137,20750,1163
6,292,20750,21042,-1,137,21042,9355
6,56,21042,21098,1,75,21042,1164
6,56,21042,21098,-1,75,21098,9356
6,92,21098,21190,1,115,21098,1165
6,92,21098,21190,-1,115,21190,9357
6,100,21190,21290,1,5,21190,1166
6,100,21190,21290,-1,5,21290,9358
6,125,21290,21415,1,177,21290,1167
6,125,21290,21415,-1,177,21415,9359
6,94,21415,21509,1,117,21415,1168
6,94,21415,21509,-1,117,21509,9360
6,124,21509,21633,1,161,21509,1169
6,124,21509,21633,-1,161,21633,9361
6,83,21633,21716,1,172,21633,1170
6,83,21633,21716,-1,172,21716,9362
6,56,21716,21772,1,77,21716,1171
6,56,21716,21772,-1,77,21772,9363
6,41,21772,21813,1,199,21772,1172
6,41,21772,21813,-1,199,21813,9364
6,102,21813,21915,1,186,21813,1173
6,102,21813,21915,-1,186,21915,9365
6,129,21915,22044,1,4,21915,1174
6,129,21915,22044,-1,4,22044,9366
6,74,22044,22118,1,224,22044,1175
6,74,22044,22118,-1,224,22118,9367
6,119,22118,22237,1,169,22118,1176
6,119,22118,22237,-1,169,22237,9368
6,72,22237,22309,1,1,22237,1177
6,72,22237,22309,-1,1,22309,9369
6,127,22309,22436,1,115,22309,1178
6,127,22309,22436,-1,115,22436,9370
6,67,22436,22503,1,191,22436,1179
6,67,22436,22503,-1,191,22503,9371
6,258,22503,22761,1,217,22503,1180
6,258,22503,22761,-1,217,22761,9372
6,182,22761,22943,1,36,22761,1181
6,182,22761,22943,-1,36,22943,9373
6,141,22943,23084,1,100,22943,1182
6,141,22943,23084,-1,100,23084,9374
6,42,23084,23126,1,50,23084,1183
6,42,23084,23126,-1,50,23126,9375
6,48,23126,23174,1,39,23126,1184
6,48,23126,23174,-1,39,23174,9376
6,211,23174,23385,1,38,23174,1185
6,211,23174,23385,-1,38,23385,9377
6,104,23385,23489,1,106,23385,1186
6,104,23385,23489,-1,106,23489,9378
6,94,23489,23583,1,130,23489,1187
6,94,23489,23583,-1,130,23583,9379
6,60,23583,23643,1,99,23583,1188
6,60,23583,23643,-1,99,23643,9380
6,61,23643,23704,1,72,23643,1189
6,61,23643,23704,-1,72,23704,9381
6,110,23704,23814,1,229,23704,1190
6,110,23704,23814,-1,229,23814,9382
6,110,23814,23924,1,89,23814,1191
6,110,23814,23924,-1,89,23924,9383
6,66,23924,23990,1,244,23924,1192
6,66,23924,23990,-1,244,23990,9384
6,62,23990,24052,1,48,23990,1193
6,62,23990,24052,-1,48,24052,9385
6,93,24052,24145,1,24,24052,1194
6,93,24052,24145,-1,24,24145,9386
6,73,24145,24218,1,202,24145,1195
6,73,24145,24218,-1,202,24218,9387
6,138,24218,24356,1,44,24218,1196
6,138,24218,24356,-1,44,24356,9388
6,57,24356,24413,1,102,24356,1197
6,57,24356,24413,-1,102,24413,9389
6,225,24413,24638,1,101,24413,1198
6,225,24413,24638,-1,101,24638,9390
6,102,24638,24740,1,140,24638,1199
6,102,24638,24740,-1,140,24740,9391
6,33,24740,24773,1,129,24740,1200
6,33,24740,24773,-1,129,24773,9392
6,273,24773,25046,1,200,24773,1201
6,273,24773,25046,-1,200,25046,9393
6,261,25046,25307,1,13,25046,1202
6,261,25046,25307,-1,13,25307,9394
6,154,25307,25461,1,238,25307,1203
6,154,25307,25461,-1,238,25461,9395
6,92,25461,25553,1,170,25461,1204
6,92,25461,25553,-1,170,25553,9396
6,105,25553,25658,1,224,25553,1205
6,105,25553,25658,-1,224,25658,9397
6,39,25658,25697,1,229,25658,1206
6,39,25658,25697,-1,229,25697,9398
6,80,25697,25777,1,157,25697,1207
6,80,25697,25777,-1,157,25777,9399
6,207,25777,25984,1,214,25777,1208
6,207,25777,25984,-1,214,25984,9400
6,134,25984,26118,1,103,25984,1209
6,134,25984,26118,-1,103,26118,9401
6,136,26118,26254,1,239,26118,1210
6,136,26118,26254,-1,239,26254,9402
6,67,26254,26321,1,33,26254,1211
6,67,26254,26321,-1,33,26321,9403
6,67,26321,26388,1,156,26321,1212
6,67,26321,26388,-1,156,26388,9404
6,139,26388,26527,1,136,26388,1213
6,139,26388,26527,-1,136,26527,9405
6,267,26527,26794,1,139,26527,1214
6,267,26527,26794,-1,139,26794,9406
6,212,26794,27006,1,5,26794,1215
6,212,26794,27006,-1,5,27006,9407
6,111,27006,27117,1,55,27006,1216
6,111,27006,27117,-1,55,27117,9408
6,127,27117,27244,1,128,27117,1217
6,127,27117,27244,-1,128,27244,9409
6,108,27244,27352,1,50,27244,1218
6,108,27244,27352,-1,50,27352,9410
6,89,27352,27441,1,202,27352,1219
6,89,27352,27441,-1,202,27441,9411
6,100,27441,27541,1,195,27441,1220
6,100,27441,27541,-1,195,27541,9412
6,64,27541,27605,1,89,27541,1221
6,64,27541,27605,-1,89,27605,9413
6,112,27605,27717,1,118,27605,1222
6,112,27605,27717,-1,118,27717,9414
6,168,27717,27885,1,33,27717,1223
6,168,27717,27885,-1,33,27885,9415
6,236,27885,28121,1,167,27885,1224
6,236,27885,28121,-1,167,28121,9416
6,89,28121,28210,1,236,28121,1225
6,89,28121,28210,-1,236,28210,9417
6,152,28210,28362,1,192,28210,1226
6,152,28210,28362,-1,192,28362,9418
6,204,28362,28566,1,38,28362,1227
6,204,28362,28566,-1,38,28566,9419
6,125,28566,28691,1,42,28566,1228
6,125,28566,28691,-1,42,28691,9420
6,143,28691,28834,1,18,28691,1229
6,143,28691,28834,-1,18,28834,9421
6,119,28834,28953,1,52,28834,1230
6,119,28834,28953,-1,52,28953,9422
6,168,28953,29121,1,21,28953,1231
6,168,28953,29121,-1,21,29121,9423
6,57,29121,29178,1,133,29121,1232
6,57,29121,29178,-1,133,29178,9424
6,79,29178,29257,1,1,29178,1233
6,79,29178,29257,-1,1,29257,9425
6,193,29257,29450,1,209,29257,1234
6,193,29257,29450,-1,209,29450,9426
6,240,29450,29690,1,253,29450,1235
6,240,29450,29690,-1,253,29690,9427
6,64,29690,29754,1,31,29690,1236
6,64,29690,29754,-1,31,29754,9428
6,167,29754,29921,1,250,29754,1237
6,167,29754,29921,-1,250,29921,9429
6,105,29921,30026,1,210,29921,1238
6,105,29921,30026,-1,210,30026,9430
6,97,30026,30123,1,99,30026,1239
6,97,30026,30123,-1,99,30123,9431
6,89,30123,30212,1,220,30123,1240
6,89,30123,30212,-1,220,30212,9432
6,34,30212,30246,1,197,30212,1241
6,34,30212,30246,-1,197,30246,9433
6,118,30246,30364,1,154,30246,1242
6,118,30246,30364,-1,154,30364,9434
6,138,30364,30502,1,107,30364,1243
6,138,30364,30502,-1,107,30502,9435
6,168,30502,30670,1,19,30502,1244
6,168,30502,30670,-1,19,30670,9436
6,211,30670,30881,1,48,30670,1245
6,211,30670,30881,-1,48,30881,9437
6,70,30881,30951,1,4,30881,1246
6,70,30881,30951,-1,4,30951,9438
6,202,30951,31153,1,251,30951,1247
6,202,30951,31153,-1,251,31153,9439
6,113,31153,31266,1,160,31153,1248
6,113,31153,31266,-1,160,31266,9440
6,95,31266,31361,1,30,31266,1249
6,95,31266,31361,-1,30,31361,9441
6,46,31361,31407,1,49,31361,1250
6,46,31361,31407,-1,49,31407,9442
6,166,31407,31573,1,67,31407,1251
6,166,31407,31573,-1,67,31573,9443
6,45,31573,31618,1,116,31573,1252
6,45,31573,31618,-1,116,31618,9444
6,157,31618,31775,1,163,31618,1253
6,157,31618,31775,-1,163,31775,9445
6,86,31775,31861,1,66,31775,1254
6,86,31775,31861,-1,66,31861,9446
6,109,31861,31970,1,106,31861,1255
6,109,31861,31970,-1,106,31970,9447
6,77,31970,32047,1,151,31970,1256
6,77,31970,32047,-1,151,32047,9448
6,135,32047,32182,1,21,32047,1257
6,135,32047,32182,-1,21,32182,9449
6,90,32182,32272,1,11,32182,1258
6,90,32182,32272,-1,11,32272,9450
7,116,0,116,1,61,0,2868
7,116,0,116,-1,61,116,11060
7,116,116,232,1,178,116,2869
7,116,116,232,-1,178,232,11061
7,82,232,314,1,46,232,2870
7,82,232,314,-1,46,314,11062
7,148,314,462,1,224,314,2871
7,148,314,462,-1,224,462,11063
7,138,462,600,1,95,462,2872
7,138,462,600,-1,95,600,11064
7,86,600,686,1,180,600,2873
7,86,600,686,-1,180,686,11065
7,50,686,736,1,21,686,2874
7,50,686,736,-1,21,736,11066
7,88,736,824,1,35,736,2875
7,88,736,824,-1,35,824,11067
7,64,824,888,1,173,824,2876
7,64,824,888,-1,173,888,11068
7,148,888,1036,1,123,888,2877
7,148,888,1036,-1,123,1036,11069
7,57,1036,1093,1,137,1036,2878
7,57,1036,1093,-1,137,1093,11070
7,204,1093,1297,1,180,1093,2879
7,204,1093,1297,-1,180,1297,11071
7,117,1297,1414,1,149,1297,2880
7,117,1297,1414,-1,149,1414,11072
7,175,1414,1589,1,204,1414,2881
7,175,1414,1589,-1,204,1589,11073
7,170,1589,1759,1,144,1589,2882
7,170,1589,1759,-1,144,1759,11074
7,124,1759,1883,1,188,1759,2883
7,124,1759,1883,-1,188,1883,11075
7,58,1883,1941,1,42,1883,2884
7,58,1883,1941,-1,42,1941,11076
7,114,1941,2055,1,8,1941,2885
7,114,1941,2055,-1,8,2055,11077
7,54,2055,2109,1,72,2055,2886
7,54,2055,2109,-1,72,2109,11078
7,137,2109,2246,1,10,2109,2887
7,137,2109,2246,-1,10,2246,11079
7,61,2246,2307,1,147,2246,2888
7,61,2246,2307,-1,147,2307,11080
7,220,2307,2527,1,224,2307,2889
7,220,2307,2527,-1,224,2527,11081
7,147,2527,2674,1,76,2527,2890
7,147,2527,2674,-1,76,2674,11082
7,65,2674,2739,1,221,2674,2891
7,65,2674,2739,-1,221,2739,11083
7,32,2739,2771,1,208,2739,2892
7,32,2739,2771,-1,208,2771,11084
7,96,2771,2867,1,231,2771,2893
7,96,2771,2867,-1,231,2867,11085
7,162,2867,3029,1,64,2867,2894
7,162,2867,3029,-1,64,3029,11086
7,23,3029,3052,1,126,3029,2895
7,23,3029,3052,-1,126,3052,11087
7,170,3052,3222,1,249,3052,2896
7,170,3052,3222,-1,249,3222,11088
7,95,3222,3317,1,13,3222,2897
7,95,3222,3317,-1,13,3317,11089
7,162,3317,3479,1,78,3317,2898
7,162,3317,3479,-1,78,3479,11090
7,89,3479,3568,1,194,3479,2899
7,89,3479,3568,-1,194,3568,11091
7,70,3568,3638,1,94,3568,2900
7,70,3568,3638,-1,94,3638,11092
7,87,3638,3725,1,185,3638,2901
7,87,3638,3725,-1,185,3725,11093
7,61,3725,3786,1,10,3725,2902
7,61,3725,3786,-1,10,3786,11094
7,45,3786,3831,1,15,3786,2903
7,45,3786,3831,-1,15,3831,11095
7,122,3831,3953,1,152,3831,2904
7,122,3831,3953,-1,152,3953,11096
7,33,3953,3986,1,225,3953,2905
7,33,3953,3986,-1,225,3986,11097
7,73,3986,4059,1,68,3986,2906
7,73,3986,4059,-1,68,4059,11098
7,98,4059,4157,1,227,4059,2907
7,98,4059,4157,-1,227,4157,11099
7,110,4157,4267,1,52,4157,2908
7,110,4157,4267,-1,52,4267,11100
7,82,4267,4349,1,195,4267,2909
7,82,4267,4349,-1,195,4349,11101
7,69,4349,4418,1,176,4349,2910
7,69,4349,4418,-1,176,4418,11102
7,130,4418,4548,1,94,4418,2911
7,130,4418,4548,-1,94,4548,11103
7,125,4548,4673,1,47,4548,2912
7,125,4548,4673,-1,47,4673,11104
7,102,4673,4775,1,161,4673,2913
7,102,4673,4775,-1,161,4775,11105
7,194,4775,4969,1,105,4775,2914
7,194,4775,4969,-1,105,4969,11106
7,110,4969,5079,1,233,4969,2915
7,110,4969,5079,-1,233,5079,11107
7,112,5079,5191,1,58,5079,2916
7,112,5079,5191,-1,58,5191,11108
7,119,5191,5310,1,166,5191,2917
7,119,5191,5310,-1,166,5310,11109
7,98,5310,5408,1,115,5310,2918
7,98,5310,5408,-1,115,5408,11110
7,132,5408,5540,1,38,5408,2919
7,132,5408,5540,-1,38,5540,11111
7,105,5540,5645,1,65,5540,2920
7,105,5540,5645,-1,65,5645,11112
7,111,5645,5756,1,163,5645,2921
7,111,5645,5756,-1,163,5756,11113
7,193,5756,5949,1,104,5756,2922
7,193,5756,5949,-1,104,5949,11114
7,160,5949,6109,1,243,5949,2923
7,160,5949,6109,-1,243,6109,11115
7,177,6109,6286,1,229,6109,2924
7,177,6109,6286,-1,229,6286,11116
7,183,6286,6469,1,202,6286,2925
7,183,6286,6469,-1,202,6469,11117
7,266,6469,6735,1,163,6469,2926
7,266,6469,6735,-1,163,6735,11118
7,127,6735,6862,1,227,6735,2927
7,127,6735,6862,-1,227,6862,11119
7,82,6862,6944,1,139,6862,2928
7,82,6862,6944,-1,139,6944,11120
7,71,6944,7015,1,152,6944,2929
7,71,6944,7015,-1,152,7015,11121
7,54,7015,7069,1,223,7015,2930
7,54,7015,7069,-1,223,7069,11122
7,146,7069,7215,1,105,7069,2931
7,146,7069,7215,-1,105,7215,11123
7,144,7215,7359,1,40,7215,2932
7,144,7215,7359,-1,40,7359,11124
7,213,7359,7572,1,81,7359,2933
7,213,7359,7572,-1,81,7572,11125
7,153,7572,7725,1,217,7572,2934
7,153,7572,7725,-1,217,7725,11126
7,89,7725,7814,1,46,7725,2935
7,89,7725,7814,-1,46,7814,11127
7,57,7814,7871,1,114,7814,2936
7,57,7814,7871,-1,114,7871,11128
7,209,7871,8080,1,253,7871,2937
7,209,7871,8080,-1,253,8080,11129
7,73,8080,8153,1,195,8080,2938
7,73,8080,8153,-1,195,8153,11130
7,143,8153,8296,1,196,8153,2939
7,143,8153,8296,-1,196,8296,11131
7,149,8296,8445,1,100,8296,2940
7,149,8296,8445,-1,100,8445,11132
7,156,8445,8601,1,100,8445,2941
7,156,8445,8601,-1,100,8601,11133
7,147,8601,8748,1,140,8601,2942
7,147,8601,8748,-1,140,8748,11134
7,108,8748,8856,1,108,8748,2943
7,108,8748,8856,-1,108,8856,11135
7,161,8856,9017,1,223,8856,2944
7,161,8856,9017,-1,223,9017,11136
7,197,9017,9214,1,108,9017,2945
7,197,9017,9214,-1,108,9214,11137
7,66,9214,9280,1,38,9214,2946
7,66,9214,9280,-1,38,9280,11138
7,47,9280,9327,1,254,9280,2947
7,47,9280,9327,-1,254,9327,11139
7,180,9327,9507,1,221,9327,2948
7,180,9327,9507,-1,221,9507,11140
7,52,9507,9559,1,125,9507,2949
7,52,9507,9559,-1,125,9559,11141
7,144,9559,9703,1,44,9559,2950
7,144,9559,9703,-1,44,9703,11142
7,140,9703,9843,1,56,9703,2951
7,140,9703,9843,-1,56,9843,11143
7,225,9843,10068,1,161,9843,2952
7,225,9843,10068,-1,161,10068,11144
7,171,10068,10239,1,230,10068,2953
7,171,10068,10239,-1,230,10239,11145
7,309,10239,10548,1,248,10239,2954
7,309,10239,10548,-1,248,10548,11146
7,114,10548,10662,1,180,10548,2955
7,114,10548,10662,-1,180,10662,11147
7,146,10662,10808,1,210,10662,2956
7,146,10662,10808,-1,210,10808,11148
7,189,10808,10997,1,154,10808,2957
7,189,10808,10997,-1,154,10997,11149
7,86,10997,11083,1,253,10997,2958
7,86,10997,11083,-1,253,11083,11150
7,78,11083,11161,1,243,11083,2959
7,78,11083,11161,-1,243,11161,11151
7,132,11161,11293,1,95,11161,2960
7,132,11161,11293,-1,95,11293,11152
7,111,11293,11404,1,228,11293,2961
7,111,11293,11404,-1,228,11404,11153
7,98,11404,11502,1,81,11404,2962
7,98,11404,11502,-1,81,11502,11154
7,135,11502,11637,1,54,11502,2963
7,135,11502,11637,-1,54,11637,11155
7,105,11637,11742,1,177,11637,2964
7,105,11637,11742,-1,177,11742,11156
7,67,11742,11809,1,114,11742,2965
7,67,11742,11809,-1,114,11809,11157
7,131,11809,11940,1,76,11809,2966
7,131,11809,11940,-1,76,11940,11158
7,83,11940,12023,1,114,11940,2967
7,83,11940,12023,-1,114,12023,11159
7,181,12023,12204,1,238,12023,2968
7,181,12023,12204,-1,238,12204,11160
7,184,12204,12388,1,173,12204,2969
7,184,12204,12388,-1,173,12388,11161
7,165,12388,12553,1,152,12388,2970
7,165,12388,12553,-1,152,12553,11162
7,20,12553,12573,1,198,12553,2971
7,20,12553,12573,-1,198,12573,11163
7,74,12573,12647,1,92,12573,2972
7,74,12573,12647,-1,92,12647,11164
7,103,12647,12750,1,126,12647,2973
7,103,12647,12750,-1,126,12750,11165
7,112,12750,12862,1,177,12750,2974
7,112,12750,12862,-1,177,12862,11166
7,93,12862,12955,1,132,12862,2975
7,93,12862,12955,-1,132,12955,11167
7,267,12955,13222,1,165,12955,2976
7,267,12955,13222,-1,165,13222,11168
7,67,13222,13289,1,252,13222,2977
7,67,13222,13289,-1,252,13289,11169
7,101,13289,13390,1,110,13289,2978
7,101,13289,13390,-1,110,13390,11170
7,105,13390,13495,1,79,13390,2979
7,105,13390,13495,-1,79,13495,11171
7,111,13495,13606,1,224,13495,2980
7,111,13495,13606,-1,224,13606,11172
7,169,13606,13775,1,122,13606,2981
7,169,13606,13775,-1,122,13775,11173
7,157,13775,13932,1,89,13775,2982
7,157,13775,13932,-1,89,13932,11174
7,284,13932,14216,1,244,13932,2983
7,284,13932,14216,-1,244,14216,11175
7,188,14216,14404,1,163,14216,2984
7,188,14216,14404,-1,163,14404,11176
7,29,14404,14433,1,118,14404,2985
7,29,14404,14433,-1,118,14433,11177
7,182,14433,14615,1,242,14433,2986
7,182,14433,14615,-1,242,14615,11178
7,90,14615,14705,1,166,14615,2987
7,90,14615,14705,-1,166,14705,11179
7,86,14705,14791,1,72,14705,2988
7,86,14705,14791,-1,72,14791,11180
7,115,14791,14906,1,49,14791,2989
7,115,14791,14906,-1,49,14906,11181
7,78,14906,14984,1,85,14906,2990
7,78,14906,14984,-1,85,14984,11182
7,39,14984,15023,1,119,14984,2991
7,39,14984,15023,-1,119,15023,11183
7,175,15023,15198,1,246,15023,2992
7,175,15023,15198,-1,246,15198,11184
7,41,15198,15239,1,127,15198,2993
7,41,15198,15239,-1,127,15239,11185
7,86,15239,15325,1,125,15239,2994
7,86,15239,15325,-1,125,15325,11186
7,126,15325,15451,1,41,15325,2995
7,126,15325,15451,-1,41,15451,11187
7,111,15451,15562,1,131,15451,2996
7,111,15451,15562,-1,131,15562,11188
7,127,15562,15689,1,110,15562,2997
7,127,15562,15689,-1,110,15689,11189
7,179,15689,15868,1,152,15689,2998
7,179,15689,15868,-1,152,15868,11190
7,152,15868,16020,1,60,15868,2999
7,152,15868,16020,-1,60,16020,11191
7,70,16020,16090,1,91,16020,3000
7,70,16020,16090,-1,91,16090,11192
7,105,16090,16195,1,16,16090,3001
7,105,16090,16195,-1,16,16195,11193
7,103,16195,16298,1,208,16195,3002
7,103,16195,16298,-1,208,16298,11194
7,223,16298,16521,1,82,16298,3003
7,223,16298,16521,-1,82,16521,11195
7,103,16521,16624,1,151,16521,3004
7,103,16521,16624,-1,151,16624,11196
7,34,16624,16658,1,254,16624,3005
7,34,16624,16658,-1,254,16658,11197
7,177,16658,16835,1,226,16658,3006
7,177,16658,16835,-1,226,16835,11198
7,153,16835,16988,1,55,16835,3007
7,153,16835,16988,-1,55,16988,11199
7,149,16988,17137,1,103,16988,3008
7,149,16988,17137,-1,103,17137,11200
7,123,17137,17260,1,64,17137,3009
7,123,17137,17260,-1,64,17260,11201
7,40,17260,17300,1,28,17260,3010
7,40,17260,17300,-1,28,17300,11202
7,216,17300,17516,1,231,17300,3011
7,216,17300,17516,-1,231,17516,11203
7,155,17516,17671,1,215,17516,3012
7,155,17516,17671,-1,215,17671,11204
7,78,17671,17749,1,32,17671,3013
7,78,17671,17749,-1,32,17749,11205
7,163,17749,17912,1,122,17749,3014
7,163,17749,17912,-1,122,17912,11206
7,40,17912,17952,1,124,17912,3015
7,40,17912,17952,-1,124,17952,11207
7,74,17952,18026,1,110,17952,3016
7,74,17952,18026,-1,110,18026,11208
7,61,18026,18087,1,171,18026,3017
7,61,18026,18087,-1,171,18087,11209
7,109,18087,18196,1,81,18087,3018
7,109,18087,18196,-1,81,18196,11210
7,136,18196,18332,1,113,18196,3019
7,136,18196,18332,-1,113,18332,11211
7,33,18332,18365,1,14,18332,3020
7,33,18332,18365,-1,14,18365,11212
7,118,18365,18483,1,141,18365,3021
7,118,18365,18483,-1,141,18483,11213
7,99,18483,18582,1,232,18483,3022
7,99,18483,18582,-1,232,18582,11214
7,133,18582,18715,1,111,18582,3023
7,133,18582,18715,-1,111,18715,11215
7,170,18715,18885,1,160,18715,3024
7,170,18715,18885,-1,160,18885,11216
7,259,18885,19144,1,96,18885,3025
7,259,18885,19144,-1,96,19144,11217
7,88,19144,19232,1,51,19144,3026
7,88,19144,19232,-1,51,19232,11218
7,40,19232,19272,1,101,19232,3027
7,40,19232,19272,-1,101,19272,11219
7,194,19272,19466,1,255,19272,3028
7,194,19272,19466,-1,255,19466,11220
7,236,19466,19702,1,243,19466,3029
7,236,19466,19702,-1,243,19702,11221
7,183,19702,19885,1,225,19702,3030
7,183,19702,19885,-1,225,19885,11222
7,215,19885,20100,1,90,19885,3031
7,215,19885,20100,-1,90,20100,11223
7,95,20100,20195,1,13,20100,3032
7,95,20100,20195,-1,13,20195,11224
7,201,20195,20396,1,52,20195,3033
7,201,20195,20396,-1,52,20396,11225
7,198,20396,20594,1,157,20396,3034
7,198,20396,20594,-1,157,20594,11226
7,171,20594,20765,1,232,20594,3035
7,171,20594,20765,-1,232,20765,11227
7,143,20765,20908,1,170,20765,3036
7,143,20765,20908,-1,170,20908,11228
7,50,20908,20958,1,31,20908,3037
7,50,20908,20958,-1,31,20958,11229
7,127,20958,21085,1,70,20958,3038
7,127,20958,21085,-1,70,21085,11230
7,98,21085,21183,1,88,21085,3039
7,98,21085,21183,-1,88,21183,11231
7,96,21183,21279,1,201,21183,3040
7,96,21183,21279,-1,201,21279,11232
7,104,21279,21383,1,127,21279,3041
7,104,21279,21383,-1,127,21383,11233
7,240,21383,21623,1,198,21383,3042
7,240,21383,21623,-1,198,21623,11234
7,180,21623,21803,1,188,21623,3043
7,180,21623,21803,-1,188,21803,11235
7,77,21803,21880,1,197,21803,3044
7,77,21803,21880,-1,197,21880,11236
7,177,21880,22057,1,216,21880,3045
7,177,21880,22057,-1,216,22057,11237
7,189,22057,22246,1,18,22057,3046
7,189,22057,22246,-1,18,22246,11238
7,110,22246,22356,1,36,22246,3047
7,110,22246,22356,-1,36,22356,11239
7,141,22356,22497,1,193,22356,3048
7,141,22356,22497,-1,193,22497,11240
7,103,22497,22600,1,106,22497,3049
7,103,22497,22600,-1,106,22600,11241
7,116,22600,22716,1,133,22600,3050
7,116,22600,22716,-1,133,22716,11242
7,119,22716,22835,1,128,22716,3051
7,119,22716,22835,-1,128,22835,11243
7,192,22835,23027,1,34,22835,3052
7,192,22835,23027,-1,34,23027,11244
7,168,23027,23195,1,144,23027,3053
7,168,23027,23195,-1,144,23195,11245
7,212,23195,23407,1,36,23195,3054
7,212,23195,23407,-1,36,23407,11246
7,144,23407,23551,1,166,23407,3055
7,144,23407,23551,-1,166,23551,11247
7,140,23551,23691,1,22,23551,3056
7,140,23551,23691,-1,22,23691,11248
7,105,23691,23796,1,256,23691,3057
7,105,23691,23796,-1,256,23796,11249
7,144,23796,23940,1,200,23796,3058
7,144,23796,23940,-1,200,23940,11250
7,163,23940,24103,1,22,23940,3059
7,163,23940,24103,-1,22,24103,11251
7,38,24103,24141,1,83,24103,3060
7,38,24103,24141,-1,83,24141,11252
7,28,24141,24169,1,113,24141,3061
7,28,24141,24169,-1,113,24169,11253
7,118,24169,24287,1,22,24169,3062
7,118,24169,24287,-1,22,24287,11254
7,132,24287,24419,1,60,24287,3063
7,132,24287,24419,-1,60,24419,11255
7,129,24419,24548,1,238,24419,3064
7,129,24419,24548,-1,238,24548,11256
7,214,24548,24762,1,29,24548,3065
7,214,24548,24762,-1,29,24762,11257
7,130,24762,24892,1,44,24762,3066
7,130,24762,24892,-1,44,24892,11258
7,260,24892,25152,1,76,24892,3067
7,260,24892,25152,-1,76,25152,11259
7,62,25152,25214,1,86,25152,3068
7,62,25152,25214,-1,86,25214,11260
7,116,25214,25330,1,178,25214,3069
7,116,25214,25330,-1,178,25330,11261
7,91,25330,25421,1,123,25330,3070
7,91,25330,25421,-1,123,25421,11262
7,160,25421,25581,1,177,25421,3071
7,160,25421,25581,-1,177,25581,11263
7,89,25581,25670,1,75,25581,3072
7,89,25581,25670,-1,75,25670,11264
7,135,25670,25805,1,48,25670,3073
7,135,25670,25805,-1,48,25805,11265
7,49,25805,25854,1,168,25805,3074
7,49,25805,25854,-1,168,25854,11266
7,59,25854,25913,1,249,25854,3075
7,59,25854,25913,-1,249,25913,11267
7,126,25913,26039,1,97,25913,3076
7,126,25913,26039,-1,97,26039,11268
7,172,26039,26211,1,183,26039,3077
7,172,26039,26211,-1,183,26211,11269
7,193,26211,26404,1,213,26211,3078
7,193,26211,26404,-1,213,26404,11270
7,61,26404,26465,1,102,26404,3079
7,61,26404,26465,-1,102,26465,11271
7,116,26465,26581,1,109,26465,3080
7,116,26465,26581,-1,109,26581,11272
7,170,26581,26751,1,94,26581,3081
7,170,26581,26751,-1,94,26751,11273
7,86,26751,26837,1,207,26751,3082
7,86,26751,26837,-1,207,26837,11274
7,47,26837,26884,1,99,26837,3083
7,47,26837,26884,-1,99,26884,11275
7,79,26884,26963,1,241,26884,3084
7,79,26884,26963,-1,241,26963,11276
7,127,26963,27090,1,253,26963,3085
7,127,26963,27090,-1,253,27090,11277
7,27,27090,27117,1,186,27090,3086
7,27,27090,27117,-1,186,27117,11278
7,54,27117,27171,1,227,27117,3087
7,54,27117,27171,-1,227,27171,11279
7,51,27171,27222,1,56,27171,3088
7,51,27171,27222,-1,56,27222,11280
7,38,27222,27260,1,194,27222,3089
7,38,27222,27260,-1,194,27260,11281
7,89,27260,27349,1,100,27260,3090
7,89,27260,27349,-1,100,27349,11282
7,157,27349,27506,1,205,27349,3091
7,157,27349,27506,-1,205,27506,11283
7,119,27506,27625,1,79,27506,3092
7,119,27506,27625,-1,79,27625,11284
7,86,27625,27711,1,29,27625,3093
7,86,27625,27711,-1,29,27711,11285
7,102,27711,27813,1,164,27711,3094
7,102,27711,27813,-1,164,27813,11286
7,80,27813,27893,1,247,27813,3095
7,80,27813,27893,-1,247,27893,11287
7,102,27893,27995,1,13,27893,3096
7,102,27893,27995,-1,13,27995,11288
7,217,27995,28212,1,69,27995,3097
7,217,27995,28212,-1,69,28212,11289
7,72,28212,28284,1,113,28212,3098
7,72,28212,28284,-1,113,28284,11290
7,102,28284,28386,1,236,28284,3099
7,102,28284,28386,-1,236,28386,11291
7,140,28386,28526,1,217,28386,3100
7,140,28386,28526,-1,217,28526,11292
7,112,28526,28638,1,139,28526,3101
7,112,28526,28638,-1,139,28638,11293
7,122,28638,28760,1,25,28638,3102
7,122,28638,28760,-1,25,28760,11294
7,60,28760,28820,1,71,28760,3103
7,60,28760,28820,-1,71,28820,11295
7,57,28820,28877,1,24,28820,3104
7,57,28820,28877,-1,24,28877,11296
7,159,28877,29036,1,7,28877,3105
7,159,28877,29036,-1,7,29036,11297
7,186,29036,29222,1,29,29036,3106
7,186,29036,29222,-1,29,29222,11298
7,164,29222,29386,1,55,29222,3107
7,164,29222,29386,-1,55,29386,11299
7,102,29386,29488,1,139,29386,3108
7,102,29386,29488,-1,139,29488,11300
7,59,29488,29547,1,52,29488,3109
7,59,29488,29547,-1,52,29547,11301
7,123,29547,29670,1,43,29547,3110
7,123,29547,29670,-1,43,29670,11302
7,79,29670,29749,1,109,29670,3111
7,79,29670,29749,-1,109,29749,11303
7,78,29749,29827,1,147,29749,3112
7,78,29749,29827,-1,147,29827,11304
7,92,29827,29919,1,91,29827,3113
7,92,29827,29919,-1,91,29919,11305
7,129,29919,30048,1,216,29919,3114
7,129,29919,30048,-1,216,30048,11306
7,39,30048,30087,1,58,30048,3115
7,39,30048,30087,-1,58,30087,11307
7,64,30087,30151,1,19,30087,3116
7,64,30087,30151,-1,19,30151,11308
8,141,0,141,1,118,0,718
8,141,0,141,-1,118,141,8910
8,187,141,328,1,201,141,719
8,187,141,328,-1,201,328,8911
8,205,328,533,1,222,328,720
8,205,328,533,-1,222,533,8912
8,105,533,638,1,99,533,721
8,105,533,638,-1,99,638,8913
8,288,638,926,1,157,638,722
8,288,638,926,-1,157,926,8914
8,233,926,1159,1,183,926,723
8,233,926,1159,-1,183,1159,8915
8,131,1159,1290,1,53,1159,724
8,131,1159,1290,-1,53,1290,8916
8,275,1290,1565,1,117,1290,725
8,275,1290,1565,-1,117,1565,8917
8,134,1565,1699,1,195,1565,726
8,134,1565,1699,-1,195,1699,8918
8,212,1699,1911,1,12,1699,727
8,212,1699,1911,-1,12,1911,8919
8,231,1911,2142,1,193,1911,728
8,231,1911,2142,-1,193,2142,8920
8,230,2142,2372,1,120,2142,729
8,230,2142,2372,-1,120,2372,8921
8,119,2372,2491,1,245,2372,730
8,119,2372,2491,-1,245,2491,8922
8,64,2491,2555,1,12,2491,731
8,64,2491,2555,-1,12,2555,8923
8,67,2555,2622,1,117,2555,732
8,67,2555,2622,-1,117,2622,8924
8,98,2622,2720,1,210,2622,733
8,98,2622,2720,-1,210,2720,8925
8,161,2720,2881,1,18,2720,734
8,161,2720,2881,-1,18,2881,8926
8,90,2881,2971,1,89,2881,735
8,90,2881,2971,-1,89,2971,8927
8,219,2971,3190,1,205,2971,736
8,219,2971,3190,-1,205,3190,8928
8,78,3190,3268,1,248,3190,737
8,78,3190,3268,-1,248,3268,8929
8,122,3268,3390,1,186,3268,738
8,122,3268,3390,-1,186,3390,8930
8,138,3390,3528,1,177,3390,739
8,138,3390,3528,-1,177,3528,8931
8,140,3528,3668,1,99,3528,740
8,140,3528,3668,-1,99,3668,8932
8,167,3668,3835,1,177,3668,741
8,167,3668,3835,-1,177,3835,8933
8,116,3835,3951,1,185,3835,742
8,116,3835,3951,-1,185,3951,8934
8,38,3951,3989,1,49,3951,743
8,38,3951,3989,-1,49,3989,8935
8,290,3989,4279,1,148,3989,744
8,290,3989,4279,-1,148,4279,8936
8,168,4279,4447,1,132,4279,745
8,168,4279,4447,-1,132,4447,8937
8,229,4447,4676,1,231,4447,746
8,229,4447,4676,-1,231,4676,8938
8,73,4676,4749,1,1,4676,747
8,73,4676,4749,-1,1,4749,8939
8,206,4749,4955,1,105,4749,748
8,206,4749,4955,-1,105,4955,8940
8,102,4955,5057,1,123,4955,749
8,102,4955,5057,-1,123,5057,8941
8,110,5057,5167,1,11,5057,750
8,110,5057,5167,-1,11,5167,8942
8,192,5167,5359,1,147,5167,751
8,192,5167,5359,-1,147,5359,8943
8,317,5359,5676,1,145,5359,752
8,317,5359,5676,-1,145,5676,8944
8,138,5676,5814,1,139,5676,753
8,138,5676,5814,-1,139,5814,8945
8,184,5814,5998,1,187,5814,754
8,184,5814,5998,-1,187,5998,8946
8,77,5998,6075,1,20,5998,755
8,77,5998,6075,-1,20,6075,8947
8,77,6075,6152,1,20,6075,756
8,77,6075,6152,-1,20,6152,8948
8,161,6152,6313,1,239,6152,757
8,161,6152,6313,-1,239,6313,8949
8,77,6313,6390,1,47,6313,758
8,77,6313,6390,-1,47,6390,8950
8,92,6390,6482,1,220,6390,759
8,92,6390,6482,-1,220,6482,8951
8,61,6482,6543,1,20,6482,760
8,61,6482,6543,-1,20,6543,8952
8,115,6543,6658,1,56,6543,761
8,115,6543,6658,-1,56,6658,8953
8,139,6658,6797,1,171,6658,762
8,139,6658,6797,-1,171,6797,8954
8,141,6797,6938,1,194,6797,763
8,141,6797,6938,-1,194,6938,8955
8,92,6938,7030,1,191,6938,764
8,92,6938,7030,-1,191,7030,8956
8,288,7030,7318,1,61,7030,765
8,288,7030,7318,-1,61,7318,8957
8,77,7318,7395,1,32,7318,766
8,77,7318,7395,-1,32,7395,8958
8,99,7395,7494,1,134,7395,767
8,99,7395,7494,-1,134,7494,8959
8,165,7494,7659,1,154,7494,768
8,165,7494,7659,-1,154,7659,8960
8,156,7659,7815,1,146,7659,769
8,156,7659,7815,-1,146,7815,8961
8,78,7815,7893,1,208,7815,770
8,78,7815,7893,-1,208,7893,8962
8,196,7893,8089,1,134,7893,771
8,196,7893,8089,-1,134,8089,8963
8,135,8089,8224,1,244,8089,772
8,135,8089,8224,-1,244,8224,8964
8,285,8224,8509,1,219,8224,773
8,285,8224,8509,-1,219,8509,8965
8,47,8509,8556,1,40,8509,774
8,47,8509,8556,-1,40,8556,8966
8,127,8556,8683,1,215,8556,775
8,127,8556,8683,-1,215,8683,8967
8,231,8683,8914,1,160,8683,776
8,231,8683,8914,-1,160,8914,8968
8,75,8914,8989,1,139,8914,777
8,75,8914,8989,-1,139,8989,8969
8,139,8989,9128,1,60,8989,778
8,139,8989,9128,-1,60,9128,8970
8,243,9128,9371,1,46,9128,779
8,243,9128,9371,-1,46,9371,8971
8,109,9371,9480,1,39,9371,780
8,109,9371,9480,-1,39,9480,8972
8,282,9480,9762,1,61,9480,781
8,282,9480,9762,-1,61,9762,8973
8,251,9762,10013,1,226,9762,782
8,251,9762,10013,-1,226,10013,8974
8,176,10013,10189,1,24,10013,783
8,176,10013,10189,-1,24,10189,8975
8,238,10189,10427,1,101,10189,784
8,238,10189,10427,-1,101,10427,8976
8,88,10427,10515,1,11,10427,785
8,88,10427,10515,-1,11,10515,8977
8,129,10515,10644,1,140,10515,786
8,129,10515,10644,-1,140,10644,8978
8,186,10644,10830,1,143,10644,787
8,186,10644,10830,-1,143,10830,8979
8,93,10830,10923,1,218,10830,788
8,93,10830,10923,-1,218,10923,8980
8,135,10923,11058,1,193,10923,789
8,135,10923,11058,-1,193,11058,8981
8,185,11058,11243,1,148,11058,790
8,185,11058,11243,-1,148,11243,8982
8,89,11243,11332,1,13,11243,791
8,89,11243,11332,-1,13,11332,8983
8,328,11332,11660,1,171,11332,792
8,328,11332,11660,-1,171,11660,8984
8,146,11660,11806,1,116,11660,793
8,146,11660,11806,-1,116,11806,8985
8,97,11806,11903,1,62,11806,794
8,97,11806,11903,-1,62,11903,8986
8,99,11903,12002,1,183,11903,795
8,99,11903,12002,-1,183,12002,8987
8,153,12002,12155,1,190,12002,796
8,153,12002,12155,-1,190,12155,8988
8,174,12155,12329,1,200,12155,797
8,174,12155,12329,-1,200,12329,8989
8,106,12329,12435,1,165,12329,798
8,106,12329,12435,-1,165,12435,8990
8,140,12435,12575,1,213,12435,799
8,140,12435,12575,-1,213,12575,8991
8,155,12575,12730,1,240,12575,800
8,155,12575,12730,-1,240,12730,8992
8,152,12730,12882,1,79,12730,801
8,152,12730,12882,-1,79,12882,8993
8,92,12882,12974,1,50,12882,802
8,92,12882,12974,-1,50,12974,8994
8,131,12974,13105,1,158,12974,803
8,131,12974,13105,-1,158,13105,8995
8,214,13105,13319,1,13,13105,804
8,214,13105,13319,-1,13,13319,8996
8,338,13319,13657,1,85,13319,805
8,338,13319,13657,-1,85,13657,8997
8,179,13657,13836,1,39,13657,806
8,179,13657,13836,-1,39,13836,8998
8,95,13836,13931,1,187,13836,807
8,95,13836,13931,-1,187,13931,8999
8,110,13931,14041,1,198,13931,808
8,110,13931,14041,-1,198,14041,9000
8,105,14041,14146,1,125,14041,809
8,105,14041,14146,-1,125,14146,9001
8,123,14146,14269,1,58,14146,810
8,123,14146,14269,-1,58,14269,9002
8,75,14269,14344,1,123,14269,811
8,75,14269,14344,-1,123,14344,9003
8,90,14344,14434,1,41,14344,812
8,90,14344,14434,-1,41,14434,9004
8,85,14434,14519,1,214,14434,813
8,85,14434,14519,-1,214,14519,9005
8,161,14519,14680,1,77,14519,814
8,161,14519,14680,-1,77,14680,9006
8,167,14680,14847,1,103,14680,815
8,167,14680,14847,-1,103,14847,9007
8,142,14847,14989,1,48,14847,816
8,142,14847,14989,-1,48,14989,9008
8,176,14989,15165,1,68,14989,817
8,176,14989,15165,-1,68,15165,9009
8,103,15165,15268,1,238,15165,818
8,103,15165,15268,-1,238,15268,9010
8,103,15268,15371,1,167,15268,819
8,103,15268,15371,-1,167,15371,9011
8,97,15371,15468,1,114,15371,820
8,97,15371,15468,-1,114,15468,9012
8,111,15468,15579,1,195,15468,821
8,111,15468,15579,-1,195,15579,9013
8,86,15579,15665,1,108,15579,822
8,86,15579,15665,-1,108,15665,9014
8,200,15665,15865,1,84,15665,823
8,200,15665,15865,-1,84,15865,9015
8,59,15865,15924,1,125,15865,824
8,59,15865,15924,-1,125,15924,9016
8,110,15924,16034,1,74,15924,825
8,110,15924,16034,-1,74,16034,9017
8,127,16034,16161,1,192,16034,826
8,127,16034,16161,-1,192,16161,9018
8,85,16161,16246,1,141,16161,827
8,85,16161,16246,-1,141,16246,9019
8,122,16246,16368,1,207,16246,828
8,122,16246,16368,-1,207,16368,9020
8,116,16368,16484,1,132,16368,829
8,116,16368,16484,-1,132,16484,9021
8,240,16484,16724,1,89,16484,830
8,240,16484,16724,-1,89,16724,9022
8,92,16724,16816,1,102,16724,831
8,92,16724,16816,-1,102,16816,9023
8,202,16816,17018,1,124,16816,832
8,202,16816,17018,-1,124,17018,9024
8,106,17018,17124,1,243,17018,833
8,106,17018,17124,-1,243,17124,9025
8,37,17124,17161,1,213,17124,834
8,37,17124,17161,-1,213,17161,9026
8,110,17161,17271,1,194,17161,835
8,110,17161,17271,-1,194,17271,9027
8,165,17271,17436,1,104,17271,836
8,165,17271,17436,-1,104,17436,9028
8,256,17436,17692,1,115,17436,837
8,256,17436,17692,-1,115,17692,9029
8,168,17692,17860,1,201,17692,838
8,168,17692,17860,-1,201,17860,9030
8,186,17860,18046,1,89,17860,839
8,186,17860,18046,-1,89,18046,9031
8,168,18046,18214,1,86,18046,840
8,168,18046,18214,-1,86,18214,9032
8,131,18214,18345,1,193,18214,841
8,131,18214,18345,-1,193,18345,9033
8,162,18345,18507,1,224,18345,842
8,162,18345,18507,-1,224,18507,9034
8,84,18507,18591,1,211,18507,843
8,84,18507,18591,-1,211,18591,9035
8,124,18591,18715,1,29,18591,844
8,124,18591,18715,-1,29,18715,9036
8,109,18715,18824,1,31,18715,845
8,109,18715,18824,-1,31,18824,9037
8,258,18824,19082,1,185,18824,846
8,258,18824,19082,-1,185,19082,9038
8,58,19082,19140,1,199,19082,847
8,58,19082,19140,-1,199,19140,9039
8,101,19140,19241,1,55,19140,848
8,101,19140,19241,-1,55,19241,9040
8,102,19241,19343,1,16,19241,849
8,102,19241,19343,-1,16,19343,9041
8,75,19343,19418,1,159,19343,850
8,75,19343,19418,-1,159,19418,9042
8,108,19418,19526,1,110,19418,851
8,108,19418,19526,-1,110,19526,9043
8,92,19526,19618,1,179,19526,852
8,92,19526,19618,-1,179,19618,9044
8,106,19618,19724,1,126,19618,853
8,106,19618,19724,-1,126,19724,9045
8,22,19724,19746,1,26,19724,854
8,22,19724,19746,-1,26,19746,9046
8,46,19746,19792,1,96,19746,855
8,46,19746,19792,-1,96,19792,9047
8,165,19792,19957,1,144,19792,856
8,165,19792,19957,-1,144,19957,9048
8,156,19957,20113,1,106,19957,857
8,156,19957,20113,-1,106,20113,9049
8,251,20113,20364,1,188,20113,858
8,251,20113,20364,-1,188,20364,9050
8,269,20364,20633,1,165,20364,859
8,269,20364,20633,-1,165,20633,9051
8,80,20633,20713,1,12,20633,860
8,80,20633,20713,-1,12,20713,9052
8,144,20713,20857,1,74,20713,861
8,144,20713,20857,-1,74,20857,9053
8,56,20857,20913,1,207,20857,862
8,56,20857,20913,-1,207,20913,9054
8,87,20913,21000,1,19,20913,863
8,87,20913,21000,-1,19,21000,9055
8,148,21000,21148,1,155,21000,864
8,148,21000,21148,-1,155,21148,9056
8,69,21148,21217,1,48,21148,865
8,69,21148,21217,-1,48,21217,9057
8,144,21217,21361,1,215,21217,866
8,144,21217,21361,-1,215,21361,9058
8,162,21361,21523,1,98,21361,867
8,162,21361,21523,-1,98,21523,9059
8,36,21523,21559,1,215,21523,868
8,36,21523,21559,-1,215,21559,9060
8,76,21559,21635,1,93,21559,869
8,76,21559,21635,-1,93,21635,9061
8,145,21635,21780,1,42,21635,870
8,145,21635,21780,-1,42,21780,9062
8,78,21780,21858,1,237,21780,871
8,78,21780,21858,-1,237,21858,9063
8,34,21858,21892,1,83,21858,872
8,34,21858,21892,-1,83,21892,9064
8,114,21892,22006,1,82,21892,873
8,114,21892,22006,-1,82,22006,9065
8,58,22006,22064,1,192,22006,874
8,58,22006,22064,-1,192,22064,9066
8,183,22064,22247,1,201,22064,875
8,183,22064,22247,-1,201,22247,9067
8,100,22247,22347,1,37,22247,876
8,100,22247,22347,-1,37,22347,9068
8,97,22347,22444,1,65,22347,877
8,97,22347,22444,-1,65,22444,9069
8,83,22444,22527,1,2,22444,878
8,83,22444,22527,-1,2,22527,9070
8,64,22527,22591,1,81,22527,879
8,64,22527,22591,-1,81,22591,9071
8,193,22591,22784,1,80,22591,880
8,193,22591,22784,-1,80,22784,9072
8,147,22784,22931,1,57,22784,881
8,147,22784,22931,-1,57,22931,9073
8,99,22931,23030,1,155,22931,882
8,99,22931,23030,-1,155,23030,9074
8,90,23030,23120,1,63,23030,883
8,90,23030,23120,-1,63,23120,9075
8,169,23120,23289,1,119,23120,884
8,169,23120,23289,-1,119,23289,9076
8,106,23289,23395,1,236,23289,885
8,106,23289,23395,-1,236,23395,9077
8,24,23395,23419,1,70,23395,886
8,24,23395,23419,-1,70,23419,9078
8,92,23419,23511,1,109,23419,887
8,92,23419,23511,-1,109,23511,9079
8,245,23511,23756,1,103,23511,888
8,245,23511,23756,-1,103,23756,9080
8,105,23756,23861,1,248,23756,889
8,105,23756,23861,-1,248,23861,9081
8,32,23861,23893,1,206,23861,890
8,32,23861,23893,-1,206,23893,9082
8,61,23893,23954,1,145,23893,891
8,61,23893,23954,-1,145,23954,9083
8,176,23954,24130,1,42,23954,892
8,176,23954,24130,-1,42,24130,9084
8,32,24130,24162,1,29,24130,893
8,32,24130,24162,-1,29,24162,9085
8,113,24162,24275,1,136,24162,894
8,113,24162,24275,-1,136,24275,9086
8,195,24275,24470,1,112,24275,895
8,195,24275,24470,-1,112,24470,9087
8,42,24470,24512,1,56,24470,896
8,42,24470,24512,-1,56,24512,9088
8,98,24512,24610,1,103,24512,897
8,98,24512,24610,-1,103,24610,9089
8,40,24610,24650,1,190,24610,898
8,40,24610,24650,-1,190,24650,9090
8,43,24650,24693,1,92,24650,899
8,43,24650,24693,-1,92,24693,9091
8,80,24693,24773,1,221,24693,900
8,80,24693,24773,-1,221,24773,9092
8,175,24773,24948,1,85,24773,901
8,175,24773,24948,-1,85,24948,9093
8,161,24948,25109,1,126,24948,902
8,161,24948,25109,-1,126,25109,9094
8,72,25109,25181,1,71,25109,903
8,72,25109,25181,-1,71,25181,9095
8,168,25181,25349,1,88,25181,904
8,168,25181,25349,-1,88,25349,9096
8,49,25349,25398,1,17,25349,905
8,49,25349,25398,-1,17,25398,9097
8,111,25398,25509,1,232,25398,906
8,111,25398,25509,-1,232,25509,9098
8,66,25509,25575,1,72,25509,907
8,66,25509,25575,-1,72,25575,9099
8,62,25575,25637,1,114,25575,908
8,62,25575,25637,-1,114,25637,9100
8,200,25637,25837,1,167,25637,909
8,200,25637,25837,-1,167,25837,9101
8,205,25837,26042,1,191,25837,910
8,205,25837,26042,-1,191,26042,9102
8,128,26042,26170,1,88,26042,911
8,128,26042,26170,-1,88,26170,9103
8,88,26170,26258,1,138,26170,912
8,88,26170,26258,-1,138,26258,9104
8,143,26258,26401,1,48,26258,913
8,143,26258,26401,-1,48,26401,9105
8,159,26401,26560,1,47,26401,914
8,159,26401,26560,-1,47,26560,9106
8,117,26560,26677,1,133,26560,915
8,117,26560,26677,-1,133,26677,9107
8,109,26677,26786,1,195,26677,916
8,109,26677,26786,-1,195,26786,9108
8,100,26786,26886,1,219,26786,917
8,100,26786,26886,-1,219,26886,9109
8,78,26886,26964,1,70,26886,918
8,78,26886,26964,-1,70,26964,9110
8,92,26964,27056,1,184,26964,919
8,92,26964,27056,-1,184,27056,9111
8,84,27056,27140,1,204,27056,920
8,84,27056,27140,-1,204,27140,9112
8,106,27140,27246,1,155,27140,921
8,106,27140,27246,-1,155,27246,9113
8,220,27246,27466,1,231,27246,922
8,220,27246,27466,-1,231,27466,9114
8,347,27466,27813,1,125,27466,923
8,347,27466,27813,-1,125,27813,9115
8,58,27813,27871,1,214,27813,924
8,58,27813,27871,-1,214,27871,9116
8,71,27871,27942,1,104,27871,925
8,71,27871,27942,-1,104,27942,9117
8,172,27942,28114,1,250,27942,926
8,172,27942,28114,-1,250,28114,9118
8,245,28114,28359,1,58,28114,927
8,245,28114,28359,-1,58,28359,9119
8,36,28359,28395,1,45,28359,928
8,36,28359,28395,-1,45,28395,9120
8,74,28395,28469,1,17,28395,929
8,74,28395,28469,-1,17,28469,9121
8,159,28469,28628,1,172,28469,930
8,159,28469,28628,-1,172,28628,9122
8,101,28628,28729,1,239,28628,931
8,101,28628,28729,-1,239,28729,9123
8,75,28729,28804,1,108,28729,932
8,75,28729,28804,-1,108,28804,9124
8,66,28804,28870,1,176,28804,933
8,66,28804,28870,-1,176,28870,9125
8,61,28870,28931,1,126,28870,934
8,61,28870,28931,-1,126,28931,9126
8,125,28931,29056,1,106,28931,935
8,125,28931,29056,-1,106,29056,9127
8,111,29056,29167,1,139,29056,936
8,111,29056,29167,-1,139,29167,9128
8,261,29167,29428,1,5,29167,937
8,261,29167,29428,-1,5,29428,9129
8,79,29428,29507,1,236,29428,938
8,79,29428,29507,-1,236,29507,9130
8,49,29507,29556,1,136,29507,939
8,49,29507,29556,-1,136,29556,9131
8,206,29556,29762,1,159,29556,940
8,206,29556,29762,-1,159,29762,9132
8,49,29762,29811,1,171,29762,941
8,49,29762,29811,-1,171,29811,9133
8,117,29811,29928,1,228,29811,942
8,117,29811,29928,-1,228,29928,9134
8,85,29928,30013,1,123,29928,943
8,85,29928,30013,-1,123,30013,9135
8,73,30013,30086,1,232,30013,944
8,73,30013,30086,-1,232,30086,9136
8,49,30086,30135,1,214,30086,945
8,49,30086,30135,-1,214,30135,9137
8,160,30135,30295,1,126,30135,946
8,160,30135,30295,-1,126,30295,9138
8,66,30295,30361,1,146,30295,947
8,66,30295,30361,-1,146,30361,9139
8,130,30361,30491,1,82,30361,948
8,130,30361,30491,-1,82,30491,9140
8,254,30491,30745,1,30,30491,949
8,254,30491,30745,-1,30,30745,9141
8,127,30745,30872,1,241,30745,950
8,127,30745,30872,-1,241,30872,9142
8,179,30872,31051,1,100,30872,951
8,179,30872,31051,-1,100,31051,9143
8,82,31051,31133,1,206,31051,952
8,82,31051,31133,-1,206,31133,9144
8,209,31133,31342,1,223,31133,953
8,209,31133,31342,-1,223,31342,9145
8,58,31342,31400,1,202,31342,954
8,58,31342,31400,-1,202,31400,9146
8,184,31400,31584,1,130,31400,955
8,184,31400,31584,-1,130,31584,9147
8,169,31584,31753,1,29,31584,956
8,169,31584,31753,-1,29,31753,9148
8,80,31753,31833,1,159,31753,957
8,80,31753,31833,-1,159,31833,9149
8,33,31833,31866,1,240,31833,958
8,33,31833,31866,-1,240,31866,9150
8,135,31866,32001,1,195,31866,959
8,135,31866,32001,-1,195,32001,9151
8,203,32001,32204,1,242,32001,960
8,203,32001,32204,-1,242,32204,9152
8,78,32204,32282,1,255,32204,961
8,78,32204,32282,-1,255,32282,9153
8,111,32282,32393,1,187,32282,962
8,111,32282,32393,-1,187,32393,9154
8,93,32393,32486,1,221,32393,963
8,93,32393,32486,-1,221,32486,9155
8,107,32486,32593,1,173,32486,964
8,107,32486,32593,-1,173,32593,9156
8,41,32593,32634,1,133,32593,965
8,41,32593,32634,-1,133,32634,9157
8,159,32634,32793,1,19,32634,966
8,159,32634,32793,-1,19,32793,9158
8,84,32793,32877,1,49,32793,967
8,84,32793,32877,-1,49,32877,9159
8,87,32877,32964,1,191,32877,968
8,87,32877,32964,-1,191,32964,9160
8,197,32964,33161,1,38,32964,969
8,197,32964,33161,-1,38,33161,9161
8,61,33161,33222,1,95,33161,970
8,61,33161,33222,-1,95,33222,9162
8,307,33222,33529,1,170,33222,971
8,307,33222,33529,-1,170,33529,9163
8,66,33529,33595,1,139,33529,972
8,66,33529,33595,-1,139,33595,9164
8,285,33595,33880,1,132,33595,973
8,285,33595,33880,-1,132,33880,9165
8,89,33880,33969,1,80,33880,974
8,89,33880,33969,-1,80,33969,9166
8,140,33969,34109,1,163,33969,975
8,140,33969,34109,-1,163,34109,9167
8,210,34109,34319,1,86,34109,976
8,210,34109,34319,-1,86,34319,9168
8,103,34319,34422,1,199,34319,977
8,103,34319,34422,-1,199,34422,9169
8,192,34422,34614,1,97,34422,978
8,192,34422,34614,-1,97,34614,9170
8,249,34614,34863,1,135,34614,979
8,249,34614,34863,-1,135,34863,9171
8,161,34863,35024,1,212,34863,980
8,161,34863,35024,-1,212,35024,9172
8,90,35024,35114,1,131,35024,981
8,90,35024,35114,-1,131,35114,9173
8,129,35114,35243,1,216,35114,982
8,129,35114,35243,-1,216,35243,9174
8,79,35243,35322,1,81,35243,983
8,79,35243,35322,-1,81,35322,9175
8,34,35322,35356,1,84,35322,984
8,34,35322,35356,-1,84,35356,9176
8,206,35356,35562,1,156,35356,985
8,206,35356,35562,-1,156,35562,9177
8,90,35562,35652,1,149,35562,986
8,90,35562,35652,-1,149,35652,9178
8,94,35652,35746,1,49,35652,987
8,94,35652,35746,-1,49,35746,9179
8,126,35746,35872,1,68,35746,988
8,126,35746,35872,-1,68,35872,9180
8,115,35872,35987,1,245,35872,989
8,115,35872,35987,-1,245,35987,9181
8,82,35987,36069,1,233,35987,990
8,82,35987,36069,-1,233,36069,9182
8,129,36069,36198,1,47,36069,991
8,129,36069,36198,-1,47,36198,9183
9,137,0,137,1,78,0,3117
9,137,0,137,-1,78,137,11309
9,81,137,218,1,179,137,3118
9,81,137,218,-1,179,218,11310
9,93,218,311,1,93,218,3119
9,93,218,311,-1,93,311,11311
9,44,311,355,1,72,311,3120
9,44,311,355,-1,72,355,11312
9,68,355,423,1,70,355,3121
9,68,355,423,-1,70,423,11313
9,116,423,539,1,196,423,3122
9,116,423,539,-1,196,539,11314
9,151,539,690,1,250,539,3123
9,151,539,690,-1,250,690,11315
9,253,690,943,1,103,690,3124
9,253,690,943,-1,103,943,11316
9,131,943,1074,1,180,943,3125
9,131,943,1074,-1,180,1074,11317
9,193,1074,1267,1,202,1074,3126
9,193,1074,1267,-1,202,1267,11318
9,91,1267,1358,1,215,1267,3127
9,91,1267,1358,-1,215,1358,11319
9,132,1358,1490,1,19,1358,3128
9,132,1358,1490,-1,19,1490,11320
9,126,1490,1616,1,122,1490,3129
9,126,1490,1616,-1,122,1616,11321
9,81,1616,1697,1,43,1616,3130
9,81,1616,1697,-1,43,1697,11322
9,130,1697,1827,1,18,1697,3131
9,130,1697,1827,-1,18,1827,11323
9,167,1827,1994,1,184,1827,3132
9,167,1827,1994,-1,184,1994,11324
9,101,1994,2095,1,227,1994,3133
9,101,1994,2095,-1,227,2095,11325
9,36,2095,2131,1,71,2095,3134
9,36,2095,2131,-1,71,2131,11326
9,135,2131,2266,1,223,2131,3135
9,135,2131,2266,-1,223,2266,11327
9,187,2266,2453,1,1,2266,3136
9,187,2266,2453,-1,1,2453,11328
9,236,2453,2689,1,141,2453,3137
9,236,2453,2689,-1,141,2689,11329
9,174,2689,2863,1,40,2689,3138
9,174,2689,2863,-1,40,2863,11330
9,152,2863,3015,1,191,2863,3139
9,152,2863,3015,-1,191,3015,11331
9,94,3015,3109,1,214,3015,3140
9,94,3015,3109,-1,214,3109,11332
9,161,3109,3270,1,104,3109,3141
9,161,3109,3270,-1,104,3270,11333
9,57,3270,3327,1,58,3270,3142
9,57,3270,3327,-1,58,3327,11334
9,147,3327,3474,1,2,3327,3143
9,147,3327,3474,-1,2,3474,11335
9,94,3474,3568,1,140,3474,3144
9,94,3474,3568,-1,140,3568,11336
9,60,3568,3628,1,198,3568,3145
9,60,3568,3628,-1,198,3628,11337
9,103,3628,3731,1,83,3628,3146
9,103,3628,3731,-1,83,3731,11338
9,290,3731,4021,1,229,3731,3147
9,290,3731,4021,-1,229,4021,11339
9,135,4021,4156,1,42,4021,3148
9,135,4021,4156,-1,42,4156,11340
9,123,4156,4279,1,171,4156,3149
9,123,4156,4279,-1,171,4279,11341
9,126,4279,4405,1,211,4279,3150
9,126,4279,4405,-1,211,4405,11342
9,132,4405,4537,1,7,4405,3151
9,132,4405,4537,-1,7,4537,11343
9,59,4537,4596,1,250,4537,3152
9,59,4537,4596,-1,250,4596,11344
9,40,4596,4636,1,102,4596,3153
9,40,4596,4636,-1,102,4636,11345
9,71,4636,4707,1,174,4636,3154
9,71,4636,4707,-1,174,4707,11346
9,292,4707,4999,1,74,4707,3155
9,292,4707,4999,-1,74,4999,11347
9,45,4999,5044,1,137,4999,3156
9,45,4999,5044,-1,137,5044,11348
9,41,5044,5085,1,148,5044,3157
9,41,5044,5085,-1,148,5085,11349
9,167,5085,5252,1,232,5085,3158
9,167,5085,5252,-1,232,5252,11350
9,146,5252,5398,1,59,5252,3159
9,146,5252,5398,-1,59,5398,11351
9,112,5398,5510,1,65,5398,3160
9,112,5398,5510,-1,65,5510,11352
9,176,5510,5686,1,94,5510,3161
9,176,5510,5686,-1,94,5686,11353
9,155,5686,5841,1,244,5686,3162
9,155,5686,5841,-1,244,5841,11354
9,124,5841,5965,1,152,5841,3163
9,124,5841,5965,-1,152,5965,11355
9,116,5965,6081,1,49,5965,3164
9,116,5965,6081,-1,49,6081,11356
9,187,6081,6268,1,2,6081,3165
9,187,6081,6268,-1,2,6268,11357
9,171,6268,6439,1,24,6268,3166
9,171,6268,6439,-1,24,6439,11358
9,120,6439,6559,1,238,6439,3167
9,120,6439,6559,-1,238,6559,11359
9,201,6559,6760,1,104,6559,3168
9,201,6559,6760,-1,104,6760,11360
9,182,6760,6942,1,219,6760,3169
9,182,6760,6942,-1,219,6942,11361
9,300,6942,7242,1,58,6942,3170
9,300,6942,7242,-1,58,7242,11362
9,61,7242,7303,1,140,7242,3171
9,61,7242,7303,-1,140,7303,11363
9,47,7303,7350,1,241,7303,3172
9,47,7303,7350,-1,241,7350,11364
9,79,7350,7429,1,177,7350,3173
9,79,7350,7429,-1,177,7429,11365
9,251,7429,7680,1,195,7429,3174
9,251,7429,7680,-1,195,7680,11366
9,57,7680,7737,1,238,7680,3175
9,57,7680,7737,-1,238,7737,11367
9,117,7737,7854,1,199,7737,3176
9,117,7737,7854,-1,199,7854,11368
9,149,7854,8003,1,109,7854,3177
9,149,7854,8003,-1,109,8003,11369
9,76,8003,8079,1,165,8003,3178
9,76,8003,8079,-1,165,8079,11370
9,86,8079,8165,1,148,8079,3179
9,86,8079,8165,-1,148,8165,11371
9,63,8165,8228,1,203,8165,3180
9,63,8165,8228,-1,203,8228,11372
9,129,8228,8357,1,167,8228,3181
9,129,8228,8357,-1,167,8357,11373
9,121,8357,8478,1,126,8357,3182
9,121,8357,8478,-1,126,8478,11374
9,162,8478,8640,1,19,8478,3183
9,162,8478,8640,-1,19,8640,11375
9,147,8640,8787,1,138,8640,3184
9,147,8640,8787,-1,138,8787,11376
9,101,8787,8888,1,197,8787,3185
9,101,8787,8888,-1,197,8888,11377
9,90,8888,8978,1,168,8888,3186
9,90,8888,8978,-1,168,8978,11378
9,74,8978,9052,1,115,8978,3187
9,74,8978,9052,-1,115,9052,11379
9,108,9052,9160,1,161,9052,3188
9,108,9052,9160,-1,161,9160,11380
9,213,9160,9373,1,66,9160,3189
9,213,9160,9373,-1,66,9373,11381
9,52,9373,9425,1,253,9373,3190
9,52,9373,9425,-1,253,9425,11382
9,192,9425,9617,1,139,9425,3191
9,192,9425,9617,-1,139,9617,11383
9,106,9617,9723,1,116,9617,3192
9,106,9617,9723,-1,116,9723,11384
9,195,9723,9918,1,149,9723,3193
9,195,9723,9918,-1,149,9918,11385
9,73,9918,9991,1,29,9918,3194
9,73,9918,9991,-1,29,9991,11386
9,174,9991,10165,1,65,9991,3195
9,174,9991,10165,-1,65,10165,11387
9,74,10165,10239,1,225,10165,3196
9,74,10165,10239,-1,225,10239,11388
9,194,10239,10433,1,71,10239,3197
9,194,10239,10433,-1,71,10433,11389
9,225,10433,10658,1,143,10433,3198
9,225,10433,10658,-1,143,10658,11390
9,169,10658,10827,1,234,10658,3199
9,169,10658,10827,-1,234,10827,11391
9,278,10827,11105,1,110,10827,3200
9,278,10827,11105,-1,110,11105,11392
9,61,11105,11166,1,254,11105,3201
9,61,11105,11166,-1,254,11166,11393
9,129,11166,11295,1,208,11166,3202
9,129,11166,11295,-1,208,11295,11394
9,229,11295,11524,1,131,11295,3203
9,229,11295,11524,-1,131,11524,11395
9,155,11524,11679,1,143,11524,3204
9,155,11524,11679,-1,143,11679,11396
9,157,11679,11836,1,124,11679,3205
9,157,11679,11836,-1,124,11836,11397
9,45,11836,11881,1,203,11836,3206
9,45,11836,11881,-1,203,11881,11398
9,74,11881,11955,1,208,11881,3207
9,74,11881,11955,-1,208,11955,11399
9,79,11955,12034,1,6,11955,3208
9,79,11955,12034,-1,6,12034,11400
9,134,12034,12168,1,214,12034,3209
9,134,12034,12168,-1,214,12168,11401
9,32,12168,12200,1,64,12168,3210
9,32,12168,12200,-1,64,12200,11402
9,107,12200,12307,1,145,12200,3211
9,107,12200,12307,-1,145,12307,11403
9,162,12307,12469,1,44,12307,3212
9,162,12307,12469,-1,44,12469,11404
9,165,12469,12634,1,22,12469,3213
9,165,12469,12634,-1,22,12634,11405
9,171,12634,12805,1,86,12634,3214
9,171,12634,12805,-1,86,12805,11406
9,137,12805,12942,1,115,12805,3215
9,137,12805,12942,-1,115,12942,11407
9,172,12942,13114,1,189,12942,3216
9,172,12942,13114,-1,189,13114,11408
9,126,13114,13240,1,218,13114,3217
9,126,13114,13240,-1,218,13240,11409
9,145,13240,13385,1,156,13240,3218
9,145,13240,13385,-1,156,13385,11410
9,105,13385,13490,1,109,13385,3219
9,105,13385,13490,-1,109,13490,11411
9,68,13490,13558,1,215,13490,3220
9,68,13490,13558,-1,215,13558,11412
9,190,13558,13748,1,93,13558,3221
9,190,13558,13748,-1,93,13748,11413
9,70,13748,13818,1,148,13748,3222
9,70,13748,13818,-1,148,13818,11414
9,184,13818,14002,1,199,13818,3223
9,184,13818,14002,-1,199,14002,11415
9,137,14002,14139,1,135,14002,3224
9,137,14002,14139,-1,135,14139,11416
9,46,14139,14185,1,2,14139,3225
9,46,14139,14185,-1,2,14185,11417
9,87,14185,14272,1,191,14185,3226
9,87,14185,14272,-1,191,14272,11418
9,148,14272,14420,1,51,14272,3227
9,148,14272,14420,-1,51,14420,11419
9,61,14420,14481,1,62,14420,3228
9,61,14420,14481,-1,62,14481,11420
9,122,14481,14603,1,142,14481,3229
9,122,14481,14603,-1,142,14603,11421
9,225,14603,14828,1,38,14603,3230
9,225,14603,14828,-1,38,14828,11422
9,87,14828,14915,1,50,14828,3231
9,87,14828,14915,-1,50,14915,11423
9,69,14915,14984,1,242,14915,3232
9,69,14915,14984,-1,242,14984,11424
9,157,14984,15141,1,149,14984,3233
9,157,14984,15141,-1,149,15141,11425
9,160,15141,15301,1,144,15141,3234
9,160,15141,15301,-1,144,15301,11426
9,249,15301,15550,1,225,15301,3235
9,249,15301,15550,-1,225,15550,11427
9,112,15550,15662,1,160,15550,3236
9,112,15550,15662,-1,160,15662,11428
9,97,15662,15759,1,77,15662,3237
9,97,15662,15759,-1,77,15759,11429
9,85,15759,15844,1,97,15759,3238
9,85,15759,15844,-1,97,15844,11430
9,86,15844,15930,1,224,15844,3239
9,86,15844,15930,-1,224,15930,11431
9,86,15930,16016,1,202,15930,3240
9,86,15930,16016,-1,202,16016,11432
9,75,16016,16091,1,223,16016,3241
9,75,16016,16091,-1,223,16091,11433
9,103,16091,16194,1,191,16091,3242
9,103,16091,16194,-1,191,16194,11434
9,134,16194,16328,1,14,16194,3243
9,134,16194,16328,-1,14,16328,11435
9,230,16328,16558,1,35,16328,3244
9,230,16328,16558,-1,35,16558,11436
9,181,16558,16739,1,105,16558,3245
9,181,16558,16739,-1,105,16739,11437
9,134,16739,16873,1,83,16739,3246
9,134,16739,16873,-1,83,16873,11438
9,105,16873,16978,1,202,16873,3247
9,105,16873,16978,-1,202,16978,11439
9,183,16978,17161,1,78,16978,3248
9,183,16978,17161,-1,78,17161,11440
9,87,17161,17248,1,234,17161,3249
9,87,17161,17248,-1,234,17248,11441
9,314,17248,17562,1,115,17248,3250
9,314,17248,17562,-1,115,17562,11442
9,197,17562,17759,1,250,17562,3251
9,197,17562,17759,-1,250,17759,11443
9,299,17759,18058,1,152,17759,3252
9,299,17759,18058,-1,152,18058,11444
9,177,18058,18235,1,175,18058,3253
9,177,18058,18235,-1,175,18235,11445
9,163,18235,18398,1,22,18235,3254
9,163,18235,18398,-1,22,18398,11446
9,122,18398,18520,1,108,18398,3255
9,122,18398,18520,-1,108,18520,11447
9,256,18520,18776,1,36,18520,3256
9,256,18520,18776,-1,36,18776,11448
9,349,18776,19125,1,212,18776,3257
9,349,18776,19125,-1,212,19125,11449
9,93,19125,19218,1,55,19125,3258
9,93,19125,19218,-1,55,19218,11450
9,90,19218,19308,1,174,19218,3259
9,90,19218,19308,-1,174,19308,11451
9,211,19308,19519,1,194,19308,3260
9,211,19308,19519,-1,194,19519,11452
9,131,19519,19650,1,44,19519,3261
9,131,19519,19650,-1,44,19650,11453
9,104,19650,19754,1,52,19650,3262
9,104,19650,19754,-1,52,19754,11454
9,66,19754,19820,1,46,19754,3263
9,66,19754,19820,-1,46,19820,11455
9,176,19820,19996,1,144,19820,3264
9,176,19820,19996,-1,144,19996,11456
9,108,19996,20104,1,59,19996,3265
9,108,19996,20104,-1,59,20104,11457
9,79,20104,20183,1,131,20104,3266
9,79,20104,20183,-1,131,20183,11458
9,141,20183,20324,1,18,20183,3267
9,141,20183,20324,-1,18,20324,11459
9,161,20324,20485,1,146,20324,3268
9,161,20324,20485,-1,146,20485,11460
9,106,20485,20591,1,251,20485,3269
9,106,20485,20591,-1,251,20591,11461
9,181,20591,20772,1,167,20591,3270
9,181,20591,20772,-1,167,20772,11462
9,85,20772,20857,1,89,20772,3271
9,85,20772,20857,-1,89,20857,11463
9,122,20857,20979,1,231,20857,3272
9,122,20857,20979,-1,231,20979,11464
9,144,20979,21123,1,167,20979,3273
9,144,20979,21123,-1,167,21123,11465
9,392,21123,21515,1,115,21123,3274
9,392,21123,21515,-1,115,21515,11466
9,57,21515,21572,1,203,21515,3275
9,57,21515,21572,-1,203,21572,11467
9,190,21572,21762,1,84,21572,3276
9,190,21572,21762,-1,84,21762,11468
9,134,21762,21896,1,49,21762,3277
9,134,21762,21896,-1,49,21896,11469
9,138,21896,22034,1,29,21896,3278
9,138,21896,22034,-1,29,22034,11470
9,86,22034,22120,1,207,22034,3279
9,86,22034,22120,-1,207,22120,11471
9,149,22120,22269,1,162,22120,3280
9,149,22120,22269,-1,162,22269,11472
9,210,22269,22479,1,103,22269,3281
9,210,22269,22479,-1,103,22479,11473
9,119,22479,22598,1,119,22479,3282
9,119,22479,22598,-1,119,22598,11474
9,247,22598,22845,1,183,22598,3283
9,247,22598,22845,-1,183,22845,11475
9,91,22845,22936,1,195,22845,3284
9,91,22845,22936,-1,195,22936,11476
9,79,22936,23015,1,238,22936,3285
9,79,22936,23015,-1,238,23015,11477
9,183,23015,23198,1,41,23015,3286
9,183,23015,23198,-1,41,23198,11478
9,102,23198,23300,1,148,23198,3287
9,102,23198,23300,-1,148,23300,11479
9,139,23300,23439,1,110,23300,3288
9,139,23300,23439,-1,110,23439,11480
9,104,23439,23543,1,2,23439,3289
9,104,23439,23543,-1,2,23543,11481
9,140,23543,23683,1,82,23543,3290
9,140,23543,23683,-1,82,23683,11482
9,51,23683,23734,1,242,23683,3291
9,51,23683,23734,-1,242,23734,11483
9,54,23734,23788,1,139,23734,3292
9,54,23734,23788,-1,139,23788,11484
9,148,23788,23936,1,161,23788,3293
9,148,23788,23936,-1,161,23936,11485
9,128,23936,24064,1,150,23936,3294
9,128,23936,24064,-1,150,24064,11486
9,36,24064,24100,1,226,24064,3295
9,36,24064,24100,-1,226,24100,11487
9,83,24100,24183,1,54,24100,3296
9,83,24100,24183,-1,54,24183,11488
9,153,24183,24336,1,222,24183,3297
9,153,24183,24336,-1,222,24336,11489
9,97,24336,24433,1,127,24336,3298
9,97,24336,24433,-1,127,24433,11490
9,261,24433,24694,1,233,24433,3299
9,261,24433,24694,-1,233,24694,11491
9,79,24694,24773,1,242,24694,3300
9,79,24694,24773,-1,242,24773,11492
9,96,24773,24869,1,18,24773,3301
9,96,24773,24869,-1,18,24869,11493
9,145,24869,25014,1,254,24869,3302
9,145,24869,25014,-1,254,25014,11494
9,23,25014,25037,1,166,25014,3303
9,23,25014,25037,-1,166,25037,11495
9,102,25037,25139,1,4,25037,3304
9,102,25037,25139,-1,4,25139,11496
9,72,25139,25211,1,254,25139,3305
9,72,25139,25211,-1,254,25211,11497
9,197,25211,25408,1,135,25211,3306
9,197,25211,25408,-1,135,25408,11498
9,121,25408,25529,1,235,25408,3307
9,121,25408,25529,-1,235,25529,11499
9,102,25529,25631,1,94,25529,3308
9,102,25529,25631,-1,94,25631,11500
9,208,25631,25839,1,185,25631,3309
9,208,25631,25839,-1,185,25839,11501
9,68,25839,25907,1,217,25839,3310
9,68,25839,25907,-1,217,25907,11502
9,185,25907,26092,1,154,25907,3311
9,185,25907,26092,-1,154,26092,11503
9,123,26092,26215,1,70,26092,3312
9,123,26092,26215,-1,70,26215,11504
9,251,26215,26466,1,18,26215,3313
9,251,26215,26466,-1,18,26466,11505
9,63,26466,26529,1,25,26466,3314
9,63,26466,26529,-1,25,26529,11506
9,117,26529,26646,1,199,26529,3315
9,117,26529,26646,-1,199,26646,11507
9,128,26646,26774,1,225,26646,3316
9,128,26646,26774,-1,225,26774,11508
9,245,26774,27019,1,159,26774,3317
9,245,26774,27019,-1,159,27019,11509
9,73,27019,27092,1,7,27019,3318
9,73,27019,27092,-1,7,27092,11510
9,89,27092,27181,1,64,27092,3319
9,89,27092,27181,-1,64,27181,11511
9,160,27181,27341,1,18,27181,3320
9,160,27181,27341,-1,18,27341,11512
9,150,27341,27491,1,64,27341,3321
9,150,27341,27491,-1,64,27491,11513
9,78,27491,27569,1,5,27491,3322
9,78,27491,27569,-1,5,27569,11514
9,79,27569,27648,1,112,27569,3323
9,79,27569,27648,-1,112,27648,11515
9,122,27648,27770,1,156,27648,3324
9,122,27648,27770,-1,156,27770,11516
9,71,27770,27841,1,131,27770,3325
9,71,27770,27841,-1,131,27841,11517
9,151,27841,27992,1,183,27841,3326
9,151,27841,27992,-1,183,27992,11518
9,130,27992,28122,1,196,27992,3327
9,130,27992,28122,-1,196,28122,11519
9,253,28122,28375,1,121,28122,3328
9,253,28122,28375,-1,121,28375,11520
9,92,28375,28467,1,193,28375,3329
9,92,28375,28467,-1,193,28467,11521
9,56,28467,28523,1,216,28467,3330
9,56,28467,28523,-1,216,28523,11522
9,243,28523,28766,1,67,28523,3331
9,243,28523,28766,-1,67,28766,11523
9,232,28766,28998,1,222,28766,3332
9,232,28766,28998,-1,222,28998,11524
9,106,28998,29104,1,188,28998,3333
9,106,28998,29104,-1,188,29104,11525
9,109,29104,29213,1,28,29104,3334
9,109,29104,29213,-1,28,29213,11526
9,128,29213,29341,1,142,29213,3335
9,128,29213,29341,-1,142,29341,11527
9,34,29341,29375,1,182,29341,3336
9,34,29341,29375,-1,182,29375,11528
9,134,29375,29509,1,131,29375,3337
9,134,29375,29509,-1,131,29509,11529
9,113,29509,29622,1,27,29509,3338
9,113,29509,29622,-1,27,29622,11530
9,135,29622,29757,1,97,29622,3339
9,135,29622,29757,-1,97,29757,11531
9,138,29757,29895,1,24,29757,3340
9,138,29757,29895,-1,24,29895,11532
9,51,29895,29946,1,159,29895,3341
9,51,29895,29946,-1,159,29946,11533
9,146,29946,30092,1,22,29946,3342
9,146,29946,30092,-1,22,30092,11534
9,69,30092,30161,1,68,30092,3343
9,69,30092,30161,-1,68,30161,11535
9,62,30161,30223,1,168,30161,3344
9,62,30161,30223,-1,168,30223,11536
9,167,30223,30390,1,169,30223,3345
9,167,30223,30390,-1,169,30390,11537
9,260,30390,30650,1,234,30390,3346
9,260,30390,30650,-1,234,30650,11538
9,100,30650,30750,1,31,30650,3347
9,100,30650,30750,-1,31,30750,11539
9,95,30750,30845,1,171,30750,3348
9,95,30750,30845,-1,171,30845,11540
9,80,30845,30925,1,2,30845,3349
9,80,30845,30925,-1,2,30925,11541
9,85,30925,31010,1,216,30925,3350
9,85,30925,31010,-1,216,31010,11542
9,120,31010,31130,1,158,31010,3351
9,120,31010,31130,-1,158,31130,11543
9,93,31130,31223,1,124,31130,3352
9,93,31130,31223,-1,124,31223,11544
9,34,31223,31257,1,67,31223,3353
9,34,31223,31257,-1,67,31257,11545
9,324,31257,31581,1,44,31257,3354
9,324,31257,31581,-1,44,31581,11546
9,74,31581,31655,1,36,31581,3355
9,74,31581,31655,-1,36,31655,11547
9,69,31655,31724,1,121,31655,3356
9,69,31655,31724,-1,121,31724,11548
9,106,31724,31830,1,208,31724,3357
9,106,31724,31830,-1,208,31830,11549
9,79,31830,31909,1,85,31830,3358
9,79,31830,31909,-1,85,31909,11550
9,138,31909,32047,1,246,31909,3359
9,138,31909,32047,-1,246,32047,11551
9,102,32047,32149,1,215,32047,3360
9,102,32047,32149,-1,215,32149,11552
9,84,32149,32233,1,91,32149,3361
9,84,32149,32233,-1,91,32233,11553
9,170,32233,32403,1,186,32233,3362
9,170,32233,32403,-1,186,32403,11554
9,78,32403,32481,1,157,32403,3363
9,78,32403,32481,-1,157,32481,11555
9,290,32481,32771,1,227,32481,3364
9,290,32481,32771,-1,227,32771,11556
9,235,32771,33006,1,219,32771,3365
9,235,32771,33006,-1,219,33006,11557
9,379,33006,33385,1,229,33006,3366
9,379,33006,33385,-1,229,33385,11558
9,219,33385,33604,1,82,33385,3367
9,219,33385,33604,-1,82,33604,11559
9,61,33604,33665,1,162,33604,3368
9,61,33604,33665,-1,162,33665,11560
9,80,33665,33745,1,5,33665,3369
9,80,33665,33745,-1,5,33745,11561
9,194,33745,33939,1,27,33745,3370
9,194,33745,33939,-1,27,33939,11562
9,135,33939,34074,1,43,33939,3371
9,135,33939,34074,-1,43,34074,11563
9,98,34074,34172,1,147,34074,3372
9,98,34074,34172,-1,147,34172,11564
9,223,34172,34395,1,90,34172,3373
9,223,34172,34395,-1,90,34395,11565
10,178,0,178,1,245,0,4150
10,178,0,178,-1,245,178,12342
10,91,178,269,1,140,178,4151
10,91,178,269,-1,140,269,12343
10,220,269,489,1,232,269,4152
10,220,269,489,-1,232,489,12344
10,146,489,635,1,129,489,4153
10,146,489,635,-1,129,635,12345
10,342,635,977,1,230,635,4154
10,342,635,977,-1,230,977,12346
10,59,977,1036,1,184,977,4155
10,59,977,1036,-1,184,1036,12347
10,188,1036,1224,1,178,1036,4156
10,188,1036,1224,-1,178,1224,12348
10,168,1224,1392,1,208,1224,4157
10,168,1224,1392,-1,208,1392,12349
10,80,1392,1472,1,185,1392,4158
10,80,1392,1472,-1,185,1472,12350
10,155,1472,1627,1,8,1472,4159
10,155,1472,1627,-1,8,1627,12351
10,114,1627,1741,1,234,1627,4160
10,114,1627,1741,-1,234,1741,12352
10,70,1741,1811,1,246,1741,4161
10,70,1741,1811,-1,246,1811,12353
10,254,1811,2065,1,230,1811,4162
10,254,1811,2065,-1,230,2065,12354
10,66,2065,2131,1,90,2065,4163
10,66,2065,2131,-1,90,2131,12355
10,184,2131,2315,1,241,2131,4164
10,184,2131,2315,-1,241,2315,12356
10,197,2315,2512,1,66,2315,4165
10,197,2315,2512,-1,66,2512,12357
10,71,2512,2583,1,15,2512,4166
10,71,2512,2583,-1,15,2583,12358
10,190,2583,2773,1,174,2583,4167
10,190,2583,2773,-1,174,2773,12359
10,81,2773,2854,1,187,2773,4168
10,81,2773,2854,-1,187,2854,12360
10,79,2854,2933,1,16,2854,4169
10,79,2854,2933,-1,16,2933,12361
10,170,2933,3103,1,132,2933,4170
10,170,2933,3103,-1,132,3103,12362
10,121,3103,3224,1,13,3103,4171
10,121,3103,3224,-1,13,3224,12363
10,97,3224,3321,1,134,3224,4172
10,97,3224,3321,-1,134,3321,12364
10,107,3321,3428,1,125,3321,4173
10,107,3321,3428,-1,125,3428,12365
10,132,3428,3560,1,7,3428,4174
10,132,3428,3560,-1,7,3560,12366
10,98,3560,3658,1,105,3560,4175
10,98,3560,3658,-1,105,3658,12367
10,80,3658,3738,1,25,3658,4176
10,80,3658,3738,-1,25,3738,12368
10,157,3738,3895,1,174,3738,4177
10,157,3738,3895,-1,174,3895,12369
10,200,3895,4095,1,159,3895,4178
10,200,3895,4095,-1,159,4095,12370
10,163,4095,4258,1,19,4095,4179
10,163,4095,4258,-1,19,4258,12371
10,71,4258,4329,1,222,4258,4180
10,71,4258,4329,-1,222,4329,12372
10,166,4329,4495,1,26,4329,4181
10,166,4329,4495,-1,26,4495,12373
10,143,4495,4638,1,133,4495,4182
10,143,4495,4638,-1,133,4638,12374
10,155,4638,4793,1,176,4638,4183
10,155,4638,4793,-1,176,4793,12375
10,144,4793,4937,1,25,4793,4184
10,144,4793,4937,-1,25,4937,12376
10,99,4937,5036,1,113,4937,4185
10,99,4937,5036,-1,113,5036,12377
10,69,5036,5105,1,146,5036,4186
10,69,5036,5105,-1,146,5105,12378
10,103,5105,5208,1,79,5105,4187
10,103,5105,5208,-1,79,5208,12379
10,174,5208,5382,1,80,5208,4188
10,174,5208,5382,-1,80,5382,12380
10,68,5382,5450,1,153,5382,4189
10,68,5382,5450,-1,153,5450,12381
10,78,5450,5528,1,225,5450,4190
10,78,5450,5528,-1,225,5528,12382
10,143,5528,5671,1,118,5528,4191
10,143,5528,5671,-1,118,5671,12383
10,161,5671,5832,1,118,5671,4192
10,161,5671,5832,-1,118,5832,12384
10,75,5832,5907,1,193,5832,4193
10,75,5832,5907,-1,193,5907,12385
10,116,5907,6023,1,146,5907,4194
10,116,5907,6023,-1,146,6023,12386
10,192,6023,6215,1,238,6023,4195
10,192,6023,6215,-1,238,6215,12387
10,68,6215,6283,1,252,6215,4196
10,68,6215,6283,-1,252,6283,12388
10,148,6283,6431,1,135,6283,4197
10,148,6283,6431,-1,135,6431,12389
10,132,6431,6563,1,255,6431,4198
10,132,6431,6563,-1,255,6563,12390
10,107,6563,6670,1,76,6563,4199
10,107,6563,6670,-1,76,6670,12391
10,102,6670,6772,1,120,6670,4200
10,102,6670,6772,-1,120,6772,12392
10,84,6772,6856,1,238,6772,4201
10,84,6772,6856,-1,238,6856,12393
10,155,6856,7011,1,74,6856,4202
10,155,6856,7011,-1,74,7011,12394
10,128,7011,7139,1,230,7011,4203
10,128,7011,7139,-1,230,7139,12395
10,118,7139,7257,1,31,7139,4204
10,118,7139,7257,-1,31,7257,12396
10,185,7257,7442,1,213,7257,4205
10,185,7257,7442,-1,213,7442,12397
10,204,7442,7646,1,40,7442,4206
10,204,7442,7646,-1,40,7646,12398
10,65,7646,7711,1,221,7646,4207
10,65,7646,7711,-1,221,7711,12399
10,175,7711,7886,1,4,7711,4208
10,175,7711,7886,-1,4,7886,12400
10,189,7886,8075,1,23,7886,4209
10,189,7886,8075,-1,23,8075,12401
10,94,8075,8169,1,123,8075,4210
10,94,8075,8169,-1,123,8169,12402
10,133,8169,8302,1,151,8169,4211
10,133,8169,8302,-1,151,8302,12403
10,85,8302,8387,1,100,8302,4212
10,85,8302,8387,-1,100,8387,12404
10,69,8387,8456,1,242,8387,4213
10,69,8387,8456,-1,242,8456,12405
10,106,8456,8562,1,38,8456,4214
10,106,8456,8562,-1,38,8562,12406
10,269,8562,8831,1,103,8562,4215
10,269,8562,8831,-1,103,8831,12407
10,89,8831,8920,1,108,8831,4216
10,89,8831,8920,-1,108,8920,12408
10,150,8920,9070,1,43,8920,4217
10,150,8920,9070,-1,43,9070,12409
10,43,9070,9113,1,221,9070,4218
10,43,9070,9113,-1,221,9113,12410
10,72,9113,9185,1,142,9113,4219
10,72,9113,9185,-1,142,9185,12411
10,139,9185,9324,1,154,9185,4220
10,139,9185,9324,-1,154,9324,12412
10,92,9324,9416,1,201,9324,4221
10,92,9324,9416,-1,201,9416,12413
10,155,9416,9571,1,63,9416,4222
10,155,9416,9571,-1,63,9571,12414
10,104,9571,9675,1,148,9571,4223
10,104,9571,9675,-1,148,9675,12415
10,273,9675,9948,1,82,9675,4224
10,273,9675,9948,-1,82,9948,12416
10,30,9948,9978,1,206,9948,4225
10,30,9948,9978,-1,206,9978,12417
10,156,9978,10134,1,226,9978,4226
10,156,9978,10134,-1,226,10134,12418
10,94,10134,10228,1,184,10134,4227
10,94,10134,10228,-1,184,10228,12419
10,190,10228,10418,1,212,10228,4228
10,190,10228,10418,-1,212,10418,12420
10,142,10418,10560,1,255,10418,4229
10,142,10418,10560,-1,255,10560,12421
10,90,10560,10650,1,205,10560,4230
10,90,10560,10650,-1,205,10650,12422
10,226,10650,10876,1,160,10650,4231
10,226,10650,10876,-1,160,10876,12423
10,124,10876,11000,1,144,10876,4232
10,124,10876,11000,-1,144,11000,12424
10,50,11000,11050,1,2,11000,4233
10,50,11000,11050,-1,2,11050,12425
10,159,11050,11209,1,27,11050,4234
10,159,11050,11209,-1,27,11209,12426
10,260,11209,11469,1,217,11209,4235
10,260,11209,11469,-1,217,11469,12427
10,206,11469,11675,1,53,11469,4236
10,206,11469,11675,-1,53,11675,12428
10,100,11675,11775,1,160,11675,4237
10,100,11675,11775,-1,160,11775,12429
10,149,11775,11924,1,156,11775,4238
10,149,11775,11924,-1,156,11924,12430
10,312,11924,12236,1,137,11924,4239
10,312,11924,12236,-1,137,12236,12431
10,68,12236,12304,1,16,12236,4240
10,68,12236,12304,-1,16,12304,12432
10,186,12304,12490,1,98,12304,4241
10,186,12304,12490,-1,98,12490,12433
10,103,12490,12593,1,67,12490,4242
10,103,12490,12593,-1,67,12593,12434
10,163,12593,12756,1,135,12593,4243
10,163,12593,12756,-1,135,12756,12435
10,73,12756,12829,1,52,12756,4244
10,73,12756,12829,-1,52,12829,12436
10,145,12829,12974,1,171,12829,4245
10,145,12829,12974,-1,171,12974,12437
10,124,12974,13098,1,238,12974,4246
10,124,12974,13098,-1,238,13098,12438
10,124,13098,13222,1,45,13098,4247
10,124,13098,13222,-1,45,13222,12439
10,73,13222,13295,1,30,13222,4248
10,73,13222,13295,-1,30,13295,12440
10,86,13295,13381,1,84,13295,4249
10,86,13295,13381,-1,84,13381,12441
10,156,13381,13537,1,98,13381,4250
10,156,13381,13537,-1,98,13537,12442
10,92,13537,13629,1,141,13537,4251
10,92,13537,13629,-1,141,13629,12443
10,82,13629,13711,1,32,13629,4252
10,82,13629,13711,-1,32,13711,12444
10,52,13711,13763,1,165,13711,4253
10,52,13711,13763,-1,165,13763,12445
10,90,13763,13853,1,23,13763,4254
10,90,13763,13853,-1,23,13853,12446
10,93,13853,13946,1,14,13853,4255
10,93,13853,13946,-1,14,13946,12447
10,115,13946,14061,1,175,13946,4256
10,115,13946,14061,-1,175,14061,12448
10,161,14061,14222,1,72,14061,4257
10,161,14061,14222,-1,72,14222,12449
10,72,14222,14294,1,241,14222,4258
10,72,14222,14294,-1,241,14294,12450
10,120,14294,14414,1,252,14294,4259
10,120,14294,14414,-1,252,14414,12451
10,124,14414,14538,1,154,14414,4260
10,124,14414,14538,-1,154,14538,12452
10,127,14538,14665,1,57,14538,4261
10,127,14538,14665,-1,57,14665,12453
10,66,14665,14731,1,6,14665,4262
10,66,14665,14731,-1,6,14731,12454
10,123,14731,14854,1,68,14731,4263
10,123,14731,14854,-1,68,14854,12455
10,80,14854,14934,1,46,14854,4264
10,80,14854,14934,-1,46,14934,12456
10,133,14934,15067,1,237,14934,4265
10,133,14934,15067,-1,237,15067,12457
10,76,15067,15143,1,212,15067,4266
10,76,15067,15143,-1,212,15143,12458
10,111,15143,15254,1,133,15143,4267
10,111,15143,15254,-1,133,15254,12459
10,147,15254,15401,1,69,15254,4268
10,147,15254,15401,-1,69,15401,12460
10,300,15401,15701,1,118,15401,4269
10,300,15401,15701,-1,118,15701,12461
10,49,15701,15750,1,163,15701,4270
10,49,15701,15750,-1,163,15750,12462
10,106,15750,15856,1,66,15750,4271
10,106,15750,15856,-1,66,15856,12463
10,98,15856,15954,1,166,15856,4272
10,98,15856,15954,-1,166,15954,12464
10,89,15954,16043,1,107,15954,4273
10,89,15954,16043,-1,107,16043,12465
10,145,16043,16188,1,153,16043,4274
10,145,16043,16188,-1,153,16188,12466
10,177,16188,16365,1,71,16188,4275
10,177,16188,16365,-1,71,16365,12467
10,53,16365,16418,1,77,16365,4276
10,53,16365,16418,-1,77,16418,12468
10,152,16418,16570,1,13,16418,4277
10,152,16418,16570,-1,13,16570,12469
10,140,16570,16710,1,171,16570,4278
10,140,16570,16710,-1,171,16710,12470
10,228,16710,16938,1,191,16710,4279
10,228,16710,16938,-1,191,16938,12471
10,89,16938,17027,1,218,16938,4280
10,89,16938,17027,-1,218,17027,12472
10,69,17027,17096,1,67,17027,4281
10,69,17027,17096,-1,67,17096,12473
10,135,17096,17231,1,10,17096,4282
10,135,17096,17231,-1,10,17231,12474
10,151,17231,17382,1,44,17231,4283
10,151,17231,17382,-1,44,17382,12475
10,47,17382,17429,1,15,17382,4284
10,47,17382,17429,-1,15,17429,12476
10,108,17429,17537,1,236,17429,4285
10,108,17429,17537,-1,236,17537,12477
10,94,17537,17631,1,115,17537,4286
10,94,17537,17631,-1,115,17631,12478
10,102,17631,17733,1,82,17631,4287
10,102,17631,17733,-1,82,17733,12479
10,86,17733,17819,1,165,17733,4288
10,86,17733,17819,-1,165,17819,12480
10,198,17819,18017,1,119,17819,4289
10,198,17819,18017,-1,119,18017,12481
10,77,18017,18094,1,107,18017,4290
10,77,18017,18094,-1,107,18094,12482
10,146,18094,18240,1,29,18094,4291
10,146,18094,18240,-1,29,18240,12483
10,91,18240,18331,1,160,18240,4292
10,91,18240,18331,-1,160,18331,12484
10,62,18331,18393,1,145,18331,4293
10,62,18331,18393,-1,145,18393,12485
10,81,18393,18474,1,176,18393,4294
10,81,18393,18474,-1,176,18474,12486
10,74,18474,18548,1,36,18474,4295
10,74,18474,18548,-1,36,18548,12487
10,233,18548,18781,1,200,18548,4296
10,233,18548,18781,-1,200,18781,12488
10,315,18781,19096,1,122,18781,4297
10,315,18781,19096,-1,122,19096,12489
10,127,19096,19223,1,184,19096,4298
10,127,19096,19223,-1,184,19223,12490
10,100,19223,19323,1,161,19223,4299
10,100,19223,19323,-1,161,19323,12491
10,96,19323,19419,1,193,19323,4300
10,96,19323,19419,-1,193,19419,12492
10,61,19419,19480,1,114,19419,4301
10,61,19419,19480,-1,114,19480,12493
10,135,19480,19615,1,69,19480,4302
10,135,19480,19615,-1,69,19615,12494
10,65,19615,19680,1,234,19615,4303
10,65,19615,19680,-1,234,19680,12495
10,35,19680,19715,1,143,19680,4304
10,35,19680,19715,-1,143,19715,12496
10,118,19715,19833,1,126,19715,4305
10,118,19715,19833,-1,126,19833,12497
10,96,19833,19929,1,249,19833,4306
10,96,19833,19929,-1,249,19929,12498
10,86,19929,20015,1,32,19929,4307
10,86,19929,20015,-1,32,20015,12499
10,59,20015,20074,1,142,20015,4308
10,59,20015,20074,-1,142,20074,12500
10,127,20074,20201,1,202,20074,4309
10,127,20074,20201,-1,202,20201,12501
10,130,20201,20331,1,130,20201,4310
10,130,20201,20331,-1,130,20331,12502
10,170,20331,20501,1,245,20331,4311
10,170,20331,20501,-1,245,20501,12503
10,195,20501,20696,1,111,20501,4312
10,195,20501,20696,-1,111,20696,12504
10,173,20696,20869,1,8,20696,4313
10,173,20696,20869,-1,8,20869,12505
10,82,20869,20951,1,242,20869,4314
10,82,20869,20951,-1,242,20951,12506
10,162,20951,21113,1,29,20951,4315
10,162,20951,21113,-1,29,21113,12507
10,57,21113,21170,1,176,21113,4316
10,57,21113,21170,-1,176,21170,12508
10,131,21170,21301,1,124,21170,4317
10,131,21170,21301,-1,124,21301,12509
10,146,21301,21447,1,239,21301,4318
10,146,21301,21447,-1,239,21447,12510
10,48,21447,21495,1,145,21447,4319
10,48,21447,21495,-1,145,21495,12511
10,151,21495,21646,1,170,21495,4320
10,151,21495,21646,-1,170,21646,12512
10,74,21646,21720,1,10,21646,4321
10,74,21646,21720,-1,10,21720,12513
10,200,21720,21920,1,13,21720,4322
10,200,21720,21920,-1,13,21920,12514
10,83,21920,22003,1,114,21920,4323
10,83,21920,22003,-1,114,22003,12515
10,154,22003,22157,1,83,22003,4324
10,154,22003,22157,-1,83,22157,12516
10,206,22157,22363,1,229,22157,4325
10,206,22157,22363,-1,229,22363,12517
10,82,22363,22445,1,12,22363,4326
10,82,22363,22445,-1,12,22445,12518
10,160,22445,22605,1,206,22445,4327
10,160,22445,22605,-1,206,22605,12519
10,38,22605,22643,1,237,22605,4328
10,38,22605,22643,-1,237,22643,12520
10,62,22643,22705,1,208,22643,4329
10,62,22643,22705,-1,208,22705,12521
10,199,22705,22904,1,103,22705,4330
10,199,22705,22904,-1,103,22904,12522
10,154,22904,23058,1,48,22904,4331
10,154,22904,23058,-1,48,23058,12523
10,235,23058,23293,1,63,23058,4332
10,235,23058,23293,-1,63,23293,12524
10,70,23293,23363,1,62,23293,4333
10,70,23293,23363,-1,62,23363,12525
10,105,23363,23468,1,148,23363,4334
10,105,23363,23468,-1,148,23468,12526
10,98,23468,23566,1,48,23468,4335
10,98,23468,23566,-1,48,23566,12527
10,178,23566,23744,1,202,23566,4336
10,178,23566,23744,-1,202,23744,12528
10,199,23744,23943,1,251,23744,4337
10,199,23744,23943,-1,251,23943,12529
10,106,23943,24049,1,199,23943,4338
10,106,23943,24049,-1,199,24049,12530
10,145,24049,24194,1,11,24049,4339
10,145,24049,24194,-1,11,24194,12531
10,147,24194,24341,1,236,24194,4340
10,147,24194,24341,-1,236,24341,12532
10,476,24341,24817,1,238,24341,4341
10,476,24341,24817,-1,238,24817,12533
10,93,24817,24910,1,160,24817,4342
10,93,24817,24910,-1,160,24910,12534
10,52,24910,24962,1,188,24910,4343
10,52,24910,24962,-1,188,24962,12535
10,204,24962,25166,1,163,24962,4344
10,204,24962,25166,-1,163,25166,12536
10,210,25166,25376,1,120,25166,4345
10,210,25166,25376,-1,120,25376,12537
10,78,25376,25454,1,215,25376,4346
10,78,25376,25454,-1,215,25454,12538
10,118,25454,25572,1,256,25454,4347
10,118,25454,25572,-1,256,25572,12539
10,213,25572,25785,1,229,25572,4348
10,213,25572,25785,-1,229,25785,12540
10,187,25785,25972,1,114,25785,4349
10,187,25785,25972,-1,114,25972,12541
10,165,25972,26137,1,179,25972,4350
10,165,25972,26137,-1,179,26137,12542
10,107,26137,26244,1,162,26137,4351
10,107,26137,26244,-1,162,26244,12543
10,204,26244,26448,1,74,26244,4352
10,204,26244,26448,-1,74,26448,12544
10,69,26448,26517,1,97,26448,4353
10,69,26448,26517,-1,97,26517,12545
10,225,26517,26742,1,99,26517,4354
10,225,26517,26742,-1,99,26742,12546
10,198,26742,26940,1,14,26742,4355
10,198,26742,26940,-1,14,26940,12547
10,68,26940,27008,1,155,26940,4356
10,68,26940,27008,-1,155,27008,12548
10,254,27008,27262,1,214,27008,4357
10,254,27008,27262,-1,214,27262,12549
10,98,27262,27360,1,199,27262,4358
10,98,27262,27360,-1,199,27360,12550
10,87,27360,27447,1,216,27360,4359
10,87,27360,27447,-1,216,27447,12551
10,142,27447,27589,1,133,27447,4360
10,142,27447,27589,-1,133,27589,12552
10,77,27589,27666,1,177,27589,4361
10,77,27589,27666,-1,177,27666,12553
10,88,27666,27754,1,18,27666,4362
10,88,27666,27754,-1,18,27754,12554
10,94,27754,27848,1,206,27754,4363
10,94,27754,27848,-1,206,27848,12555
10,139,27848,27987,1,134,27848,4364
10,139,27848,27987,-1,134,27987,12556
10,211,27987,28198,1,117,27987,4365
10,211,27987,28198,-1,117,28198,12557
10,75,28198,28273,1,207,28198,4366
10,75,28198,28273,-1,207,28273,12558
10,94,28273,28367,1,237,28273,4367
10,94,28273,28367,-1,237,28367,12559
10,169,28367,28536,1,169,28367,4368
10,169,28367,28536,-1,169,28536,12560
10,157,28536,28693,1,204,28536,4369
10,157,28536,28693,-1,204,28693,12561
10,122,28693,28815,1,187,28693,4370
10,122,28693,28815,-1,187,28815,12562
10,50,28815,28865,1,211,28815,4371
10,50,28815,28865,-1,211,28865,12563
10,206,28865,29071,1,236,28865,4372
10,206,28865,29071,-1,236,29071,12564
10,183,29071,29254,1,151,29071,4373
10,183,29071,29254,-1,151,29254,12565
10,215,29254,29469,1,254,29254,4374
10,215,29254,29469,-1,254,29469,12566
10,130,29469,29599,1,110,29469,4375
10,130,29469,29599,-1,110,29599,12567
10,120,29599,29719,1,151,29599,4376
10,120,29599,29719,-1,151,29719,12568
10,207,29719,29926,1,98,29719,4377
10,207,29719,29926,-1,98,29926,12569
10,25,29926,29951,1,19,29926,4378
10,25,29926,29951,-1,19,29951,12570
10,85,29951,30036,1,78,29951,4379
10,85,29951,30036,-1,78,30036,12571
10,157,30036,30193,1,114,30036,4380
10,157,30036,30193,-1,114,30193,12572
10,55,30193,30248,1,38,30193,4381
10,55,30193,30248,-1,38,30248,12573
10,69,30248,30317,1,21,30248,4382
10,69,30248,30317,-1,21,30317,12574
10,218,30317,30535,1,45,30317,4383
10,218,30317,30535,-1,45,30535,12575
10,245,30535,30780,1,152,30535,4384
10,245,30535,30780,-1,152,30780,12576
10,97,30780,30877,1,68,30780,4385
10,97,30780,30877,-1,68,30877,12577
10,191,30877,31068,1,126,30877,4386
10,191,30877,31068,-1,126,31068,12578
10,36,31068,31104,1,124,31068,4387
10,36,31068,31104,-1,124,31104,12579
10,224,31104,31328,1,186,31104,4388
10,224,31104,31328,-1,186,31328,12580
10,56,31328,31384,1,237,31328,4389
10,56,31328,31384,-1,237,31384,12581
10,178,31384,31562,1,137,31384,4390
10,178,31384,31562,-1,137,31562,12582
10,147,31562,31709,1,171,31562,4391
10,147,31562,31709,-1,171,31709,12583
10,138,31709,31847,1,163,31709,4392
10,138,31709,31847,-1,163,31847,12584
10,152,31847,31999,1,133,31847,4393
10,152,31847,31999,-1,133,31999,12585
10,84,31999,32083,1,4,31999,4394
10,84,31999,32083,-1,4,32083,12586
10,75,32083,32158,1,48,32083,4395
10,75,32083,32158,-1,48,32158,12587
10,108,32158,32266,1,143,32158,4396
10,108,32158,32266,-1,143,32266,12588
10,113,32266,32379,1,226,32266,4397
10,113,32266,32379,-1,226,32379,12589
10,73,32379,32452,1,230,32379,4398
10,73,32379,32452,-1,230,32452,12590
10,100,32452,32552,1,55,32452,4399
10,100,32452,32552,-1,55,32552,12591
10,224,32552,32776,1,86,32552,4400
10,224,32552,32776,-1,86,32776,12592
10,63,32776,32839,1,118,32776,4401
10,63,32776,32839,-1,118,32839,12593
10,108,32839,32947,1,50,32839,4402
10,108,32839,32947,-1,50,32947,12594
10,133,32947,33080,1,61,32947,4403
10,133,32947,33080,-1,61,33080,12595
10,170,33080,33250,1,11,33080,4404
10,170,33080,33250,-1,11,33250,12596
11,53,0,53,1,173,0,3896
11,53,0,53,-1,173,53,12088
11,64,53,117,1,96,53,3897
11,64,53,117,-1,96,117,12089
11,180,117,297,1,125,117,3898
11,180,117,297,-1,125,297,12090
11,99,297,396,1,81,297,3899
11,99,297,396,-1,81,396,12091
11,123,396,519,1,80,396,3900
11,123,396,519,-1,80,519,12092
11,329,519,848,1,159,519,3901
11,329,519,848,-1,159,848,12093
11,62,848,910,1,207,848,3902
11,62,848,910,-1,207,910,12094
11,117,910,1027,1,16,910,3903
11,117,910,1027,-1,16,1027,12095
11,149,1027,1176,1,210,1027,3904
11,149,1027,1176,-1,210,1176,12096
11,111,1176,1287,1,248,1176,3905
11,111,1176,1287,-1,248,1287,12097
11,118,1287,1405,1,200,1287,3906
11,118,1287,1405,-1,200,1405,12098
11,175,1405,1580,1,144,1405,3907
11,175,1405,1580,-1,144,1580,12099
11,50,1580,1630,1,152,1580,3908
11,50,1580,1630,-1,152,1630,12100
11,232,1630,1862,1,13,1630,3909
11,232,1630,1862,-1,13,1862,12101
11,131,1862,1993,1,152,1862,3910
11,131,1862,1993,-1,152,1993,12102
11,101,1993,2094,1,154,1993,3911
11,101,1993,2094,-1,154,2094,12103
11,114,2094,2208,1,46,2094,3912
11,114,2094,2208,-1,46,2208,12104
11,41,2208,2249,1,28,2208,3913
11,41,2208,2249,-1,28,2249,12105
11,192,2249,2441,1,145,2249,3914
11,192,2249,2441,-1,145,2441,12106
11,60,2441,2501,1,231,2441,3915
11,60,2441,2501,-1,231,2501,12107
11,114,2501,2615,1,236,2501,3916
11,114,2501,2615,-1,236,2615,12108
11,77,2615,2692,1,156,2615,3917
11,77,2615,2692,-1,156,2692,12109
11,232,2692,2924,1,238,2692,3918
11,232,2692,2924,-1,238,2924,12110
11,132,2924,3056,1,170,2924,3919
11,132,2924,3056,-1,170,3056,12111
11,150,3056,3206,1,200,3056,3920
11,150,3056,3206,-1,200,3206,12112
11,99,3206,3305,1,101,3206,3921
11,99,3206,3305,-1,101,3305,12113
11,119,3305,3424,1,7,3305,3922
11,119,3305,3424,-1,7,3424,12114
11,226,3424,3650,1,217,3424,3923
11,226,3424,3650,-1,217,3650,12115
11,118,3650,3768,1,249,3650,3924
11,118,3650,3768,-1,249,3768,12116
11,187,3768,3955,1,245,3768,3925
11,187,3768,3955,-1,245,3955,12117
11,121,3955,4076,1,81,3955,3926
11,121,3955,4076,-1,81,4076,12118
11,30,4076,4106,1,161,4076,3927
11,30,4076,4106,-1,161,4106,12119
11,51,4106,4157,1,204,4106,3928
11,51,4106,4157,-1,204,4157,12120
11,87,4157,4244,1,14,4157,3929
11,87,4157,4244,-1,14,4244,12121
11,25,4244,4269,1,57,4244,3930
11,25,4244,4269,-1,57,4269,12122
11,17,4269,4286,1,170,4269,3931
11,17,4269,4286,-1,170,4286,12123
11,134,4286,4420,1,248,4286,3932
11,134,4286,4420,-1,248,4420,12124
11,249,4420,4669,1,222,4420,3933
11,249,4420,4669,-1,222,4669,12125
11,265,4669,4934,1,103,4669,3934
11,265,4669,4934,-1,103,4934,12126
11,115,4934,5049,1,146,4934,3935
11,115,4934,5049,-1,146,5049,12127
11,179,5049,5228,1,55,5049,3936
11,179,5049,5228,-1,55,5228,12128
11,227,5228,5455,1,169,5228,3937
11,227,5228,5455,-1,169,5455,12129
11,109,5455,5564,1,227,5455,3938
11,109,5455,5564,-1,227,5564,12130
11,81,5564,5645,1,247,5564,3939
11,81,5564,5645,-1,247,5645,12131
11,117,5645,5762,1,72,5645,3940
11,117,5645,5762,-1,72,5762,12132
11,62,5762,5824,1,101,5762,3941
11,62,5762,5824,-1,101,5824,12133
11,92,5824,5916,1,132,5824,3942
11,92,5824,5916,-1,132,5916,12134
11,135,5916,6051,1,3,5916,3943
11,135,5916,6051,-1,3,6051,12135
11,215,6051,6266,1,221,6051,3944
11,215,6051,6266,-1,221,6266,12136
11,258,6266,6524,1,41,6266,3945
11,258,6266,6524,-1,41,6524,12137
11,191,6524,6715,1,50,6524,3946
11,191,6524,6715,-1,50,6715,12138
11,218,6715,6933,1,70,6715,3947
11,218,6715,6933,-1,70,6933,12139
11,110,6933,7043,1,152,6933,3948
11,110,6933,7043,-1,152,7043,12140
11,145,7043,7188,1,88,7043,3949
11,145,7043,7188,-1,88,7188,12141
11,163,7188,7351,1,138,7188,3950
11,163,7188,7351,-1,138,7351,12142
11,178,7351,7529,1,185,7351,3951
11,178,7351,7529,-1,185,7529,12143
11,70,7529,7599,1,148,7529,3952
11,70,7529,7599,-1,148,7599,12144
11,153,7599,7752,1,25,7599,3953
11,153,7599,7752,-1,25,7752,12145
11,217,7752,7969,1,135,7752,3954
11,217,7752,7969,-1,135,7969,12146
11,161,7969,8130,1,66,7969,3955
11,161,7969,8130,-1,66,8130,12147
11,61,8130,8191,1,21,8130,3956
11,61,8130,8191,-1,21,8191,12148
11,60,8191,8251,1,227,8191,3957
11,60,8191,8251,-1,227,8251,12149
11,90,8251,8341,1,123,8251,3958
11,90,8251,8341,-1,123,8341,12150
11,139,8341,8480,1,227,8341,3959
11,139,8341,8480,-1,227,8480,12151
11,256,8480,8736,1,215,8480,3960
11,256,8480,8736,-1,215,8736,12152
11,53,8736,8789,1,26,8736,3961
11,53,8736,8789,-1,26,8789,12153
11,213,8789,9002,1,132,8789,3962
11,213,8789,9002,-1,132,9002,12154
11,84,9002,9086,1,173,9002,3963
11,84,9002,9086,-1,173,9086,12155
11,229,9086,9315,1,187,9086,3964
11,229,9086,9315,-1,187,9315,12156
11,85,9315,9400,1,96,9315,3965
11,85,9315,9400,-1,96,9400,12157
11,132,9400,9532,1,188,9400,3966
11,132,9400,9532,-1,188,9532,12158
11,86,9532,9618,1,136,9532,3967
11,86,9532,9618,-1,136,9618,12159
11,142,9618,9760,1,6,9618,3968
11,142,9618,9760,-1,6,9760,12160
11,111,9760,9871,1,107,9760,3969
11,111,9760,9871,-1,107,9871,12161
11,109,9871,9980,1,148,9871,3970
11,109,9871,9980,-1,148,9980,12162
11,225,9980,10205,1,239,9980,3971
11,225,9980,10205,-1,239,10205,12163
11,99,10205,10304,1,230,10205,3972
11,99,10205,10304,-1,230,10304,12164
11,130,10304,10434,1,202,10304,3973
11,130,10304,10434,-1,202,10434,12165
11,162,10434,10596,1,213,10434,3974
11,162,10434,10596,-1,213,10596,12166
11,98,10596,10694,1,252,10596,3975
11,98,10596,10694,-1,252,10694,12167
11,66,10694,10760,1,114,10694,3976
11,66,10694,10760,-1,114,10760,12168
11,338,10760,11098,1,176,10760,3977
11,338,10760,11098,-1,176,11098,12169
11,321,11098,11419,1,137,11098,3978
11,321,11098,11419,-1,137,11419,12170
11,135,11419,11554,1,251,11419,3979
11,135,11419,11554,-1,251,11554,12171
11,99,11554,11653,1,232,11554,3980
11,99,11554,11653,-1,232,11653,12172
11,119,11653,11772,1,166,11653,3981
11,119,11653,11772,-1,166,11772,12173
11,109,11772,11881,1,56,11772,3982
11,109,11772,11881,-1,56,11881,12174
11,90,11881,11971,1,23,11881,3983
11,90,11881,11971,-1,23,11971,12175
11,70,11971,12041,1,243,11971,3984
11,70,11971,12041,-1,243,12041,12176
11,76,12041,12117,1,42,12041,3985
11,76,12041,12117,-1,42,12117,12177
11,184,12117,12301,1,2,12117,3986
11,184,12117,12301,-1,2,12301,12178
11,107,12301,12408,1,115,12301,3987
11,107,12301,12408,-1,115,12408,12179
11,110,12408,12518,1,96,12408,3988
11,110,12408,12518,-1,96,12518,12180
11,172,12518,12690,1,187,12518,3989
11,172,12518,12690,-1,187,12690,12181
11,43,12690,12733,1,85,12690,3990
11,43,12690,12733,-1,85,12733,12182
11,81,12733,12814,1,233,12733,3991
11,81,12733,12814,-1,233,12814,12183
11,164,12814,12978,1,121,12814,3992
11,164,12814,12978,-1,121,12978,12184
11,93,12978,13071,1,107,12978,3993
11,93,12978,13071,-1,107,13071,12185
11,179,13071,13250,1,87,13071,3994
11,179,13071,13250,-1,87,13250,12186
11,62,13250,13312,1,69,13250,3995
11,62,13250,13312,-1,69,13312,12187
11,72,13312,13384,1,157,13312,3996
11,72,13312,13384,-1,157,13384,12188
11,159,13384,13543,1,119,13384,3997
11,159,13384,13543,-1,119,13543,12189
11,125,13543,13668,1,216,13543,3998
11,125,13543,13668,-1,216,13668,12190
11,41,13668,13709,1,132,13668,3999
11,41,13668,13709,-1,132,13709,12191
11,143,13709,13852,1,2,13709,4000
11,143,13709,13852,-1,2,13852,12192
11,191,13852,14043,1,7,13852,4001
11,191,13852,14043,-1,7,14043,12193
11,97,14043,14140,1,125,14043,4002
11,97,14043,14140,-1,125,14140,12194
11,89,14140,14229,1,52,14140,4003
11,89,14140,14229,-1,52,14229,12195
11,207,14229,14436,1,250,14229,4004
11,207,14229,14436,-1,250,14436,12196
11,95,14436,14531,1,115,14436,4005
11,95,14436,14531,-1,115,14531,12197
11,213,14531,14744,1,31,14531,4006
11,213,14531,14744,-1,31,14744,12198
11,129,14744,14873,1,93,14744,4007
11,129,14744,14873,-1,93,14873,12199
11,210,14873,15083,1,200,14873,4008
11,210,14873,15083,-1,200,15083,12200
11,209,15083,15292,1,9,15083,4009
11,209,15083,15292,-1,9,15292,12201
11,105,15292,15397,1,108,15292,4010
11,105,15292,15397,-1,108,15397,12202
11,173,15397,15570,1,208,15397,4011
11,173,15397,15570,-1,208,15570,12203
11,116,15570,15686,1,205,15570,4012
11,116,15570,15686,-1,205,15686,12204
11,108,15686,15794,1,100,15686,4013
11,108,15686,15794,-1,100,15794,12205
11,94,15794,15888,1,150,15794,4014
11,94,15794,15888,-1,150,15888,12206
11,137,15888,16025,1,71,15888,4015
11,137,15888,16025,-1,71,16025,12207
11,193,16025,16218,1,100,16025,4016
11,193,16025,16218,-1,100,16218,12208
11,74,16218,16292,1,54,16218,4017
11,74,16218,16292,-1,54,16292,12209
11,84,16292,16376,1,218,16292,4018
11,84,16292,16376,-1,218,16376,12210
11,87,16376,16463,1,157,16376,4019
11,87,16376,16463,-1,157,16463,12211
11,120,16463,16583,1,114,16463,4020
11,120,16463,16583,-1,114,16583,12212
11,121,16583,16704,1,22,16583,4021
11,121,16583,16704,-1,22,16704,12213
11,58,16704,16762,1,143,16704,4022
11,58,16704,16762,-1,143,16762,12214
11,30,16762,16792,1,141,16762,4023
11,30,16762,16792,-1,141,16792,12215
11,109,16792,16901,1,131,16792,4024
11,109,16792,16901,-1,131,16901,12216
11,229,16901,17130,1,218,16901,4025
11,229,16901,17130,-1,218,17130,12217
11,87,17130,17217,1,183,17130,4026
11,87,17130,17217,-1,183,17217,12218
11,128,17217,17345,1,134,17217,4027
11,128,17217,17345,-1,134,17345,12219
11,229,17345,17574,1,8,17345,4028
11,229,17345,17574,-1,8,17574,12220
11,164,17574,17738,1,122,17574,4029
11,164,17574,17738,-1,122,17738,12221
11,75,17738,17813,1,1,17738,4030
11,75,17738,17813,-1,1,17813,12222
11,72,17813,17885,1,226,17813,4031
11,72,17813,17885,-1,226,17885,12223
11,194,17885,18079,1,213,17885,4032
11,194,17885,18079,-1,213,18079,12224
11,175,18079,18254,1,55,18079,4033
11,175,18079,18254,-1,55,18254,12225
11,290,18254,18544,1,237,18254,4034
11,290,18254,18544,-1,237,18544,12226
11,159,18544,18703,1,42,18544,4035
11,159,18544,18703,-1,42,18703,12227
11,88,18703,18791,1,200,18703,4036
11,88,18703,18791,-1,200,18791,12228
11,114,18791,18905,1,183,18791,4037
11,114,18791,18905,-1,183,18905,12229
11,206,18905,19111,1,135,18905,4038
11,206,18905,19111,-1,135,19111,12230
11,211,19111,19322,1,112,19111,4039
11,211,19111,19322,-1,112,19322,12231
11,131,19322,19453,1,52,19322,4040
11,131,19322,19453,-1,52,19453,12232
11,190,19453,19643,1,249,19453,4041
11,190,19453,19643,-1,249,19643,12233
11,204,19643,19847,1,186,19643,4042
11,204,19643,19847,-1,186,19847,12234
11,162,19847,20009,1,19,19847,4043
11,162,19847,20009,-1,19,20009,12235
11,188,20009,20197,1,156,20009,4044
11,188,20009,20197,-1,156,20197,12236
11,196,20197,20393,1,60,20197,4045
11,196,20197,20393,-1,60,20393,12237
11,41,20393,20434,1,218,20393,4046
11,41,20393,20434,-1,218,20434,12238
11,118,20434,20552,1,57,20434,4047
11,118,20434,20552,-1,57,20552,12239
11,140,20552,20692,1,49,20552,4048
11,140,20552,20692,-1,49,20692,12240
11,131,20692,20823,1,150,20692,4049
11,131,20692,20823,-1,150,20823,12241
11,126,20823,20949,1,48,20823,4050
11,126,20823,20949,-1,48,20949,12242
11,91,20949,21040,1,158,20949,4051
11,91,20949,21040,-1,158,21040,12243
11,213,21040,21253,1,223,21040,4052
11,213,21040,21253,-1,223,21253,12244
11,159,21253,21412,1,43,21253,4053
11,159,21253,21412,-1,43,21412,12245
11,21,21412,21433,1,20,21412,4054
11,21,21412,21433,-1,20,21433,12246
11,97,21433,21530,1,166,21433,4055
11,97,21433,21530,-1,166,21530,12247
11,140,21530,21670,1,78,21530,4056
11,140,21530,21670,-1,78,21670,12248
11,221,21670,21891,1,124,21670,4057
11,221,21670,21891,-1,124,21891,12249
11,162,21891,22053,1,74,21891,4058
11,162,21891,22053,-1,74,22053,12250
11,175,22053,22228,1,29,22053,4059
11,175,22053,22228,-1,29,22228,12251
11,126,22228,22354,1,246,22228,4060
11,126,22228,22354,-1,246,22354,12252
11,55,22354,22409,1,105,22354,4061
11,55,22354,22409,-1,105,22409,12253
11,123,22409,22532,1,67,22409,4062
11,123,22409,22532,-1,67,22532,12254
11,104,22532,22636,1,225,22532,4063
11,104,22532,22636,-1,225,22636,12255
11,52,22636,22688,1,82,22636,4064
11,52,22636,22688,-1,82,22688,12256
11,119,22688,22807,1,196,22688,4065
11,119,22688,22807,-1,196,22807,12257
11,208,22807,23015,1,252,22807,4066
11,208,22807,23015,-1,252,23015,12258
11,115,23015,23130,1,205,23015,4067
11,115,23015,23130,-1,205,23130,12259
11,249,23130,23379,1,62,23130,4068
11,249,23130,23379,-1,62,23379,12260
11,32,23379,23411,1,35,23379,4069
11,32,23379,23411,-1,35,23411,12261
11,495,23411,23906,1,21,23411,4070
11,495,23411,23906,-1,21,23906,12262
11,207,23906,24113,1,209,23906,4071
11,207,23906,24113,-1,209,24113,12263
11,109,24113,24222,1,171,24113,4072
11,109,24113,24222,-1,171,24222,12264
11,90,24222,24312,1,113,24222,4073
11,90,24222,24312,-1,113,24312,12265
11,219,24312,24531,1,134,24312,4074
11,219,24312,24531,-1,134,24531,12266
11,79,24531,24610,1,57,24531,4075
11,79,24531,24610,-1,57,24610,12267
11,75,24610,24685,1,73,24610,4076
11,75,24610,24685,-1,73,24685,12268
11,40,24685,24725,1,152,24685,4077
11,40,24685,24725,-1,152,24725,12269
11,200,24725,24925,1,146,24725,4078
11,200,24725,24925,-1,146,24925,12270
11,72,24925,24997,1,1,24925,4079
11,72,24925,24997,-1,1,24997,12271
11,158,24997,25155,1,10,24997,4080
11,158,24997,25155,-1,10,25155,12272
11,105,25155,25260,1,88,25155,4081
11,105,25155,25260,-1,88,25260,12273
11,111,25260,25371,1,169,25260,4082
11,111,25260,25371,-1,169,25371,12274
11,130,25371,25501,1,67,25371,4083
11,130,25371,25501,-1,67,25501,12275
11,141,25501,25642,1,97,25501,4084
11,141,25501,25642,-1,97,25642,12276
11,59,25642,25701,1,31,25642,4085
11,59,25642,25701,-1,31,25701,12277
11,85,25701,25786,1,103,25701,4086
11,85,25701,25786,-1,103,25786,12278
11,223,25786,26009,1,100,25786,4087
11,223,25786,26009,-1,100,26009,12279
11,135,26009,26144,1,193,26009,4088
11,135,26009,26144,-1,193,26144,12280
11,145,26144,26289,1,132,26144,4089
11,145,26144,26289,-1,132,26289,12281
11,74,26289,26363,1,212,26289,4090
11,74,26289,26363,-1,212,26363,12282
11,126,26363,26489,1,118,26363,4091
11,126,26363,26489,-1,118,26489,12283
11,102,26489,26591,1,196,26489,4092
11,102,26489,26591,-1,196,26591,12284
11,236,26591,26827,1,129,26591,4093
11,236,26591,26827,-1,129,26827,12285
11,202,26827,27029,1,90,26827,4094
11,202,26827,27029,-1,90,27029,12286
11,73,27029,27102,1,93,27029,4095
11,73,27029,27102,-1,93,27102,12287
11,134,27102,27236,1,174,27102,4096
11,134,27102,27236,-1,174,27236,12288
11,105,27236,27341,1,142,27236,4097
11,105,27236,27341,-1,142,27341,12289
11,227,27341,27568,1,139,27341,4098
11,227,27341,27568,-1,139,27568,12290
11,75,27568,27643,1,120,27568,4099
11,75,27568,27643,-1,120,27643,12291
11,137,27643,27780,1,145,27643,4100
11,137,27643,27780,-1,145,27780,12292
11,362,27780,28142,1,42,27780,4101
11,362,27780,28142,-1,42,28142,12293
11,74,28142,28216,1,81,28142,4102
11,74,28142,28216,-1,81,28216,12294
11,109,28216,28325,1,251,28216,4103
11,109,28216,28325,-1,251,28325,12295
11,113,28325,28438,1,62,28325,4104
11,113,28325,28438,-1,62,28438,12296
11,103,28438,28541,1,246,28438,4105
11,103,28438,28541,-1,246,28541,12297
11,48,28541,28589,1,5,28541,4106
11,48,28541,28589,-1,5,28589,12298
11,83,28589,28672,1,248,28589,4107
11,83,28589,28672,-1,248,28672,12299
11,203,28672,28875,1,122,28672,4108
11,203,28672,28875,-1,122,28875,12300
11,184,28875,29059,1,184,28875,4109
11,184,28875,29059,-1,184,29059,12301
11,132,29059,29191,1,136,29059,4110
11,132,29059,29191,-1,136,29191,12302
11,124,29191,29315,1,230,29191,4111
11,124,29191,29315,-1,230,29315,12303
11,59,29315,29374,1,211,29315,4112
11,59,29315,29374,-1,211,29374,12304
11,133,29374,29507,1,79,29374,4113
11,133,29374,29507,-1,79,29507,12305
11,87,29507,29594,1,161,29507,4114
11,87,29507,29594,-1,161,29594,12306
11,108,29594,29702,1,55,29594,4115
11,108,29594,29702,-1,55,29702,12307
11,248,29702,29950,1,208,29702,4116
11,248,29702,29950,-1,208,29950,12308
11,171,29950,30121,1,128,29950,4117
11,171,29950,30121,-1,128,30121,12309
11,71,30121,30192,1,90,30121,4118
11,71,30121,30192,-1,90,30192,12310
11,58,30192,30250,1,256,30192,4119
11,58,30192,30250,-1,256,30250,12311
11,255,30250,30505,1,183,30250,4120
11,255,30250,30505,-1,183,30505,12312
11,88,30505,30593,1,197,30505,4121
11,88,30505,30593,-1,197,30593,12313
11,259,30593,30852,1,39,30593,4122
11,259,30593,30852,-1,39,30852,12314
11,126,30852,30978,1,54,30852,4123
11,126,30852,30978,-1,54,30978,12315
11,116,30978,31094,1,21,30978,4124
11,116,30978,31094,-1,21,31094,12316
11,285,31094,31379,1,109,31094,4125
11,285,31094,31379,-1,109,31379,12317
11,106,31379,31485,1,64,31379,4126
11,106,31379,31485,-1,64,31485,12318
11,193,31485,31678,1,4,31485,4127
11,193,31485,31678,-1,4,31678,12319
11,115,31678,31793,1,78,31678,4128
11,115,31678,31793,-1,78,31793,12320
11,86,31793,31879,1,56,31793,4129
11,86,31793,31879,-1,56,31879,12321
11,136,31879,32015,1,163,31879,4130
11,136,31879,32015,-1,163,32015,12322
11,110,32015,32125,1,250,32015,4131
11,110,32015,32125,-1,250,32125,12323
11,133,32125,32258,1,75,32125,4132
11,133,32125,32258,-1,75,32258,12324
11,119,32258,32377,1,192,32258,4133
11,119,32258,32377,-1,192,32377,12325
11,279,32377,32656,1,154,32377,4134
11,279,32377,32656,-1,154,32656,12326
11,88,32656,32744,1,42,32656,4135
11,88,32656,32744,-1,42,32744,12327
11,106,32744,32850,1,141,32744,4136
11,106,32744,32850,-1,141,32850,12328
11,97,32850,32947,1,11,32850,4137
11,97,32850,32947,-1,11,32947,12329
11,162,32947,33109,1,163,32947,4138
11,162,32947,33109,-1,163,33109,12330
11,104,33109,33213,1,243,33109,4139
11,104,33109,33213,-1,243,33213,12331
11,133,33213,33346,1,107,33213,4140
11,133,33213,33346,-1,107,33346,12332
11,53,33346,33399,1,95,33346,4141
11,53,33346,33399,-1,95,33399,12333
11,178,33399,33577,1,21,33399,4142
11,178,33399,33577,-1,21,33577,12334
11,104,33577,33681,1,224,33577,4143
11,104,33577,33681,-1,224,33681,12335
11,83,33681,33764,1,212,33681,4144
11,83,33681,33764,-1,212,33764,12336
11,118,33764,33882,1,203,33764,4145
11,118,33764,33882,-1,203,33882,12337
11,154,33882,34036,1,52,33882,4146
11,154,33882,34036,-1,52,34036,12338
11,99,34036,34135,1,100,34036,4147
11,99,34036,34135,-1,100,34135,12339
11,112,34135,34247,1,149,34135,4148
11,112,34135,34247,-1,149,34247,12340
11,140,34247,34387,1,176,34247,4149
11,140,34247,34387,-1,176,34387,12341
12,77,0,77,1,123,0,5170
12,77,0,77,-1,123,77,13362
12,48,77,125,1,16,77,5171
12,48,77,125,-1,16,125,13363
12,113,125,238,1,164,125,5172
12,113,125,238,-1,164,238,13364
12,99,238,337,1,136,238,5173
12,99,238,337,-1,136,337,13365
12,187,337,524,1,92,337,5174
12,187,337,524,-1,92,524,13366
12,72,524,596,1,114,524,5175
12,72,524,596,-1,114,596,13367
12,151,596,747,1,161,596,5176
12,151,596,747,-1,161,747,13368
12,72,747,819,1,167,747,5177
12,72,747,819,-1,167,819,13369
12,32,819,851,1,243,819,5178
12,32,819,851,-1,243,851,13370
12,296,851,1147,1,123,851,5179
12,296,851,1147,-1,123,1147,13371
12,150,1147,1297,1,146,1147,5180
12,150,1147,1297,-1,146,1297,13372
12,21,1297,1318,1,221,1297,5181
12,21,1297,1318,-1,221,1318,13373
12,75,1318,1393,1,9,1318,5182
12,75,1318,1393,-1,9,1393,13374
12,84,1393,1477,1,224,1393,5183
12,84,1393,1477,-1,224,1477,13375
12,81,1477,1558,1,219,1477,5184
12,81,1477,1558,-1,219,1558,13376
12,205,1558,1763,1,33,1558,5185
12,205,1558,1763,-1,33,1763,13377
12,61,1763,1824,1,163,1763,5186
12,61,1763,1824,-1,163,1824,13378
12,86,1824,1910,1,153,1824,5187
12,86,1824,1910,-1,153,1910,13379
12,155,1910,2065,1,120,1910,5188
12,155,1910,2065,-1,120,2065,13380
12,117,2065,2182,1,181,2065,5189
12,117,2065,2182,-1,181,2182,13381
12,86,2182,2268,1,236,2182,5190
12,86,2182,2268,-1,236,2268,13382
12,86,2268,2354,1,169,2268,5191
12,86,2268,2354,-1,169,2354,13383
12,110,2354,2464,1,35,2354,5192
12,110,2354,2464,-1,35,2464,13384
12,104,2464,2568,1,239,2464,5193
12,104,2464,2568,-1,239,2568,13385
12,219,2568,2787,1,101,2568,5194
12,219,2568,2787,-1,101,2787,13386
12,159,2787,2946,1,250,2787,5195
12,159,2787,2946,-1,250,2946,13387
12,126,2946,3072,1,64,2946,5196
12,126,2946,3072,-1,64,3072,13388
12,77,3072,3149,1,32,3072,5197
12,77,3072,3149,-1,32,3149,13389
12,90,3149,3239,1,255,3149,5198
12,90,3149,3239,-1,255,3239,13390
12,162,3239,3401,1,79,3239,5199
12,162,3239,3401,-1,79,3401,13391
12,52,3401,3453,1,227,3401,5200
12,52,3401,3453,-1,227,3453,13392
12,114,3453,3567,1,178,3453,5201
12,114,3453,3567,-1,178,3567,13393
12,121,3567,3688,1,53,3567,5202
12,121,3567,3688,-1,53,3688,13394
12,201,3688,3889,1,57,3688,5203
12,201,3688,3889,-1,57,3889,13395
12,81,3889,3970,1,240,3889,5204
12,81,3889,3970,-1,240,3970,13396
12,126,3970,4096,1,107,3970,5205
12,126,3970,4096,-1,107,4096,13397
12,87,4096,4183,1,96,4096,5206
12,87,4096,4183,-1,96,4183,13398
12,130,4183,4313,1,216,4183,5207
12,130,4183,4313,-1,216,4313,13399
12,141,4313,4454,1,206,4313,5208
12,141,4313,4454,-1,206,4454,13400
12,104,4454,4558,1,142,4454,5209
12,104,4454,4558,-1,142,4558,13401
12,82,4558,4640,1,147,4558,5210
12,82,4558,4640,-1,147,4640,13402
12,97,4640,4737,1,15,4640,5211
12,97,4640,4737,-1,15,4737,13403
12,78,4737,4815,1,89,4737,5212
12,78,4737,4815,-1,89,4815,13404
12,118,4815,4933,1,229,4815,5213
12,118,4815,4933,-1,229,4933,13405
12,77,4933,5010,1,61,4933,5214
12,77,4933,5010,-1,61,5010,13406
12,178,5010,5188,1,16,5010,5215
12,178,5010,5188,-1,16,5188,13407
12,111,5188,5299,1,203,5188,5216
12,111,5188,5299,-1,203,5299,13408
12,154,5299,5453,1,223,5299,5217
12,154,5299,5453,-1,223,5453,13409
12,76,5453,5529,1,211,5453,5218
12,76,5453,5529,-1,211,5529,13410
12,176,5529,5705,1,118,5529,5219
12,176,5529,5705,-1,118,5705,13411
12,67,5705,5772,1,97,5705,5220
12,67,5705,5772,-1,97,5772,13412
12,60,5772,5832,1,11,5772,5221
12,60,5772,5832,-1,11,5832,13413
12,102,5832,5934,1,3,5832,5222
12,102,5832,5934,-1,3,5934,13414
12,117,5934,6051,1,242,5934,5223
12,117,5934,6051,-1,242,6051,13415
12,102,6051,6153,1,254,6051,5224
12,102,6051,6153,-1,254,6153,13416
12,134,6153,6287,1,76,6153,5225
12,134,6153,6287,-1,76,6287,13417
12,127,6287,6414,1,252,6287,5226
12,127,6287,6414,-1,252,6414,13418
12,139,6414,6553,1,243,6414,5227
12,139,6414,6553,-1,243,6553,13419
12,80,6553,6633,1,101,6553,5228
12,80,6553,6633,-1,101,6633,13420
12,82,6633,6715,1,105,6633,5229
12,82,6633,6715,-1,105,6715,13421
12,68,6715,6783,1,108,6715,5230
12,68,6715,6783,-1,108,6783,13422
12,57,6783,6840,1,62,6783,5231
12,57,6783,6840,-1,62,6840,13423
12,127,6840,6967,1,159,6840,5232
12,127,6840,6967,-1,159,6967,13424
12,164,6967,7131,1,189,6967,5233
12,164,6967,7131,-1,189,7131,13425
12,211,7131,7342,1,199,7131,5234
12,211,7131,7342,-1,199,7342,13426
12,172,7342,7514,1,111,7342,5235
12,172,7342,7514,-1,111,7514,13427
12,159,7514,7673,1,127,7514,5236
12,159,7514,7673,-1,127,7673,13428
12,105,7673,7778,1,223,7673,5237
12,105,7673,7778,-1,223,7778,13429
12,90,7778,7868,1,62,7778,5238
12,90,7778,7868,-1,62,7868,13430
12,104,7868,7972,1,131,7868,5239
12,104,7868,7972,-1,131,7972,13431
12,89,7972,8061,1,14,7972,5240
12,89,7972,8061,-1,14,8061,13432
12,181,8061,8242,1,23,8061,5241
12,181,8061,8242,-1,23,8242,13433
12,86,8242,8328,1,241,8242,5242
12,86,8242,8328,-1,241,8328,13434
12,124,8328,8452,1,120,8328,5243
12,124,8328,8452,-1,120,8452,13435
12,66,8452,8518,1,208,8452,5244
12,66,8452,8518,-1,208,8518,13436
12,102,8518,8620,1,101,8518,5245
12,102,8518,8620,-1,101,8620,13437
12,61,8620,8681,1,96,8620,5246
12,61,8620,8681,-1,96,8681,13438
12,31,8681,8712,1,84,8681,5247
12,31,8681,8712,-1,84,8712,13439
12,193,8712,8905,1,79,8712,5248
12,193,8712,8905,-1,79,8905,13440
12,103,8905,9008,1,159,8905,5249
12,103,8905,9008,-1,159,9008,13441
12,120,9008,9128,1,161,9008,5250
12,120,9008,9128,-1,161,9128,13442
12,59,9128,9187,1,13,9128,5251
12,59,9128,9187,-1,13,9187,13443
12,42,9187,9229,1,6,9187,5252
12,42,9187,9229,-1,6,9229,13444
12,167,9229,9396,1,196,9229,5253
12,167,9229,9396,-1,196,9396,13445
12,14,9396,9410,1,26,9396,5254
12,14,9396,9410,-1,26,9410,13446
12,58,9410,9468,1,16,9410,5255
12,58,9410,9468,-1,16,9468,13447
12,102,9468,9570,1,251,9468,5256
12,102,9468,9570,-1,251,9570,13448
12,109,9570,9679,1,166,9570,5257
12,109,9570,9679,-1,166,9679,13449
12,157,9679,9836,1,234,9679,5258
12,157,9679,9836,-1,234,9836,13450
12,110,9836,9946,1,41,9836,5259
12,110,9836,9946,-1,41,9946,13451
12,149,9946,10095,1,253,9946,5260
12,149,9946,10095,-1,253,10095,13452
12,62,10095,10157,1,79,10095,5261
12,62,10095,10157,-1,79,10157,13453
12,64,10157,10221,1,121,10157,5262
12,64,10157,10221,-1,121,10221,13454
12,262,10221,10483,1,148,10221,5263
12,262,10221,10483,-1,148,10483,13455
12,143,10483,10626,1,121,10483,5264
12,143,10483,10626,-1,121,10626,13456
12,114,10626,10740,1,129,10626,5265
12,114,10626,10740,-1,129,10740,13457
12,187,10740,10927,1,36,10740,5266
12,187,10740,10927,-1,36,10927,13458
12,160,10927,11087,1,96,10927,5267
12,160,10927,11087,-1,96,11087,13459
12,116,11087,11203,1,53,11087,5268
12,116,11087,11203,-1,53,11203,13460
12,122,11203,11325,1,149,11203,5269
12,122,11203,11325,-1,149,11325,13461
12,190,11325,11515,1,219,11325,5270
12,190,11325,11515,-1,219,11515,13462
12,148,11515,11663,1,52,11515,5271
12,148,11515,11663,-1,52,11663,13463
12,48,11663,11711,1,180,11663,5272
12,48,11663,11711,-1,180,11711,13464
12,183,11711,11894,1,201,11711,5273
12,183,11711,11894,-1,201,11894,13465
12,57,11894,11951,1,180,11894,5274
12,57,11894,11951,-1,180,11951,13466
12,91,11951,12042,1,75,11951,5275
12,91,11951,12042,-1,75,12042,13467
12,80,12042,12122,1,86,12042,5276
12,80,12042,12122,-1,86,12122,13468
12,181,12122,12303,1,157,12122,5277
12,181,12122,12303,-1,157,12303,13469
12,57,12303,12360,1,207,12303,5278
12,57,12303,12360,-1,207,12360,13470
12,167,12360,12527,1,187,12360,5279
12,167,12360,12527,-1,187,12527,13471
12,123,12527,12650,1,163,12527,5280
12,123,12527,12650,-1,163,12650,13472
12,79,12650,12729,1,145,12650,5281
12,79,12650,12729,-1,145,12729,13473
12,190,12729,12919,1,233,12729,5282
12,190,12729,12919,-1,233,12919,13474
12,152,12919,13071,1,36,12919,5283
12,152,12919,13071,-1,36,13071,13475
12,141,13071,13212,1,39,13071,5284
12,141,13071,13212,-1,39,13212,13476
12,204,13212,13416,1,45,13212,5285
12,204,13212,13416,-1,45,13416,13477
12,84,13416,13500,1,92,13416,5286
12,84,13416,13500,-1,92,13500,13478
12,101,13500,13601,1,76,13500,5287
12,101,13500,13601,-1,76,13601,13479
12,92,13601,13693,1,91,13601,5288
12,92,13601,13693,-1,91,13693,13480
12,102,13693,13795,1,116,13693,5289
12,102,13693,13795,-1,116,13795,13481
12,82,13795,13877,1,113,13795,5290
12,82,13795,13877,-1,113,13877,13482
12,152,13877,14029,1,155,13877,5291
12,152,13877,14029,-1,155,14029,13483
12,196,14029,14225,1,133,14029,5292
12,196,14029,14225,-1,133,14225,13484
12,200,14225,14425,1,33,14225,5293
12,200,14225,14425,-1,33,14425,13485
12,286,14425,14711,1,191,14425,5294
12,286,14425,14711,-1,191,14711,13486
12,48,14711,14759,1,51,14711,5295
12,48,14711,14759,-1,51,14759,13487
12,143,14759,14902,1,245,14759,5296
12,143,14759,14902,-1,245,14902,13488
12,84,14902,14986,1,37,14902,5297
12,84,14902,14986,-1,37,14986,13489
12,184,14986,15170,1,126,14986,5298
12,184,14986,15170,-1,126,15170,13490
12,103,15170,15273,1,63,15170,5299
12,103,15170,15273,-1,63,15273,13491
12,163,15273,15436,1,92,15273,5300
12,163,15273,15436,-1,92,15436,13492
12,100,15436,15536,1,149,15436,5301
12,100,15436,15536,-1,149,15536,13493
12,73,15536,15609,1,39,15536,5302
12,73,15536,15609,-1,39,15609,13494
12,91,15609,15700,1,209,15609,5303
12,91,15609,15700,-1,209,15700,13495
12,108,15700,15808,1,57,15700,5304
12,108,15700,15808,-1,57,15808,13496
12,264,15808,16072,1,245,15808,5305
12,264,15808,16072,-1,245,16072,13497
12,289,16072,16361,1,251,16072,5306
12,289,16072,16361,-1,251,16361,13498
12,98,16361,16459,1,37,16361,5307
12,98,16361,16459,-1,37,16459,13499
12,102,16459,16561,1,140,16459,5308
12,102,16459,16561,-1,140,16561,13500
12,126,16561,16687,1,230,16561,5309
12,126,16561,16687,-1,230,16687,13501
12,192,16687,16879,1,23,16687,5310
12,192,16687,16879,-1,23,16879,13502
12,173,16879,17052,1,156,16879,5311
12,173,16879,17052,-1,156,17052,13503
12,91,17052,17143,1,139,17052,5312
12,91,17052,17143,-1,139,17143,13504
12,144,17143,17287,1,128,17143,5313
12,144,17143,17287,-1,128,17287,13505
12,114,17287,17401,1,201,17287,5314
12,114,17287,17401,-1,201,17401,13506
12,92,17401,17493,1,141,17401,5315
12,92,17401,17493,-1,141,17493,13507
12,146,17493,17639,1,24,17493,5316
12,146,17493,17639,-1,24,17639,13508
12,48,17639,17687,1,131,17639,5317
12,48,17639,17687,-1,131,17687,13509
12,84,17687,17771,1,95,17687,5318
12,84,17687,17771,-1,95,17771,13510
12,99,17771,17870,1,203,17771,5319
12,99,17771,17870,-1,203,17870,13511
12,327,17870,18197,1,43,17870,5320
12,327,17870,18197,-1,43,18197,13512
12,181,18197,18378,1,144,18197,5321
12,181,18197,18378,-1,144,18378,13513
12,117,18378,18495,1,44,18378,5322
12,117,18378,18495,-1,44,18495,13514
12,85,18495,18580,1,110,18495,5323
12,85,18495,18580,-1,110,18580,13515
12,199,18580,18779,1,181,18580,5324
12,199,18580,18779,-1,181,18779,13516
12,78,18779,18857,1,226,18779,5325
12,78,18779,18857,-1,226,18857,13517
12,76,18857,18933,1,129,18857,5326
12,76,18857,18933,-1,129,18933,13518
12,120,18933,19053,1,122,18933,5327
12,120,18933,19053,-1,122,19053,13519
12,98,19053,19151,1,256,19053,5328
12,98,19053,19151,-1,256,19151,13520
12,171,19151,19322,1,195,19151,5329
12,171,19151,19322,-1,195,19322,13521
12,81,19322,19403,1,140,19322,5330
12,81,19322,19403,-1,140,19403,13522
12,134,19403,19537,1,236,19403,5331
12,134,19403,19537,-1,236,19537,13523
12,237,19537,19774,1,127,19537,5332
12,237,19537,19774,-1,127,19774,13524
12,72,19774,19846,1,144,19774,5333
12,72,19774,19846,-1,144,19846,13525
12,129,19846,19975,1,129,19846,5334
12,129,19846,19975,-1,129,19975,13526
12,109,19975,20084,1,210,19975,5335
12,109,19975,20084,-1,210,20084,13527
12,136,20084,20220,1,41,20084,5336
12,136,20084,20220,-1,41,20220,13528
12,102,20220,20322,1,25,20220,5337
12,102,20220,20322,-1,25,20322,13529
12,169,20322,20491,1,16,20322,5338
12,169,20322,20491,-1,16,20491,13530
12,61,20491,20552,1,41,20491,5339
12,61,20491,20552,-1,41,20552,13531
12,42,20552,20594,1,138,20552,5340
12,42,20552,20594,-1,138,20594,13532
12,59,20594,20653,1,166,20594,5341
12,59,20594,20653,-1,166,20653,13533
12,194,20653,20847,1,35,20653,5342
12,194,20653,20847,-1,35,20847,13534
12,271,20847,21118,1,234,20847,5343
12,271,20847,21118,-1,234,21118,13535
12,118,21118,21236,1,19,21118,5344
12,118,21118,21236,-1,19,21236,13536
12,153,21236,21389,1,147,21236,5345
12,153,21236,21389,-1,147,21389,13537
12,81,21389,21470,1,72,21389,5346
12,81,21389,21470,-1,72,21470,13538
12,254,21470,21724,1,120,21470,5347
12,254,21470,21724,-1,120,21724,13539
12,84,21724,21808,1,142,21724,5348
12,84,21724,21808,-1,142,21808,13540
12,99,21808,21907,1,5,21808,5349
12,99,21808,21907,-1,5,21907,13541
12,63,21907,21970,1,150,21907,5350
12,63,21907,21970,-1,150,21970,13542
12,109,21970,22079,1,250,21970,5351
12,109,21970,22079,-1,250,22079,13543
12,161,22079,22240,1,106,22079,5352
12,161,22079,22240,-1,106,22240,13544
12,140,22240,22380,1,155,22240,5353
12,140,22240,22380,-1,155,22380,13545
12,148,22380,22528,1,195,22380,5354
12,148,22380,22528,-1,195,22528,13546
12,89,22528,22617,1,56,22528,5355
12,89,22528,22617,-1,56,22617,13547
12,63,22617,22680,1,185,22617,5356
12,63,22617,22680,-1,185,22680,13548
12,76,22680,22756,1,81,22680,5357
12,76,22680,22756,-1,81,22756,13549
12,128,22756,22884,1,55,22756,5358
12,128,22756,22884,-1,55,22884,13550
12,325,22884,23209,1,108,22884,5359
12,325,22884,23209,-1,108,23209,13551
12,86,23209,23295,1,26,23209,5360
12,86,23209,23295,-1,26,23295,13552
12,147,23295,23442,1,8,23295,5361
12,147,23295,23442,-1,8,23442,13553
12,157,23442,23599,1,201,23442,5362
12,157,23442,23599,-1,201,23599,13554
12,39,23599,23638,1,252,23599,5363
12,39,23599,23638,-1,252,23638,13555
12,90,23638,23728,1,132,23638,5364
12,90,23638,23728,-1,132,23728,13556
12,76,23728,23804,1,208,23728,5365
12,76,23728,23804,-1,208,23804,13557
12,112,23804,23916,1,69,23804,5366
12,112,23804,23916,-1,69,23916,13558
12,211,23916,24127,1,136,23916,5367
12,211,23916,24127,-1,136,24127,13559
12,113,24127,24240,1,90,24127,5368
12,113,24127,24240,-1,90,24240,13560
12,49,24240,24289,1,36,24240,5369
12,49,24240,24289,-1,36,24289,13561
12,52,24289,24341,1,245,24289,5370
12,52,24289,24341,-1,245,24341,13562
12,63,24341,24404,1,216,24341,5371
12,63,24341,24404,-1,216,24404,13563
12,92,24404,24496,1,130,24404,5372
12,92,24404,24496,-1,130,24496,13564
12,116,24496,24612,1,76,24496,5373
12,116,24496,24612,-1,76,24612,13565
12,85,24612,24697,1,1,24612,5374
12,85,24612,24697,-1,1,24697,13566
12,206,24697,24903,1,147,24697,5375
12,206,24697,24903,-1,147,24903,13567
12,138,24903,25041,1,212,24903,5376
12,138,24903,25041,-1,212,25041,13568
12,117,25041,25158,1,16,25041,5377
12,117,25041,25158,-1,16,25158,13569
12,152,25158,25310,1,221,25158,5378
12,152,25158,25310,-1,221,25310,13570
12,65,25310,25375,1,28,25310,5379
12,65,25310,25375,-1,28,25375,13571
12,110,25375,25485,1,42,25375,5380
12,110,25375,25485,-1,42,25485,13572
12,219,25485,25704,1,226,25485,5381
12,219,25485,25704,-1,226,25704,13573
12,118,25704,25822,1,176,25704,5382
12,118,25704,25822,-1,176,25822,13574
12,39,25822,25861,1,69,25822,5383
12,39,25822,25861,-1,69,25861,13575
12,54,25861,25915,1,29,25861,5384
12,54,25861,25915,-1,29,25915,13576
12,249,25915,26164,1,252,25915,5385
12,249,25915,26164,-1,252,26164,13577
12,136,26164,26300,1,114,26164,5386
12,136,26164,26300,-1,114,26300,13578
12,165,26300,26465,1,144,26300,5387
12,165,26300,26465,-1,144,26465,13579
12,141,26465,26606,1,125,26465,5388
12,141,26465,26606,-1,125,26606,13580
12,63,26606,26669,1,58,26606,5389
12,63,26606,26669,-1,58,26669,13581
12,101,26669,26770,1,15,26669,5390
12,101,26669,26770,-1,15,26770,13582
12,84,26770,26854,1,124,26770,5391
12,84,26770,26854,-1,124,26854,13583
12,183,26854,27037,1,38,26854,5392
12,183,26854,27037,-1,38,27037,13584
12,60,27037,27097,1,17,27037,5393
12,60,27037,27097,-1,17,27097,13585
12,48,27097,27145,1,166,27097,5394
12,48,27097,27145,-1,166,27145,13586
12,57,27145,27202,1,74,27145,5395
12,57,27145,27202,-1,74,27202,13587
12,88,27202,27290,1,39,27202,5396
12,88,27202,27290,-1,39,27290,13588
12,233,27290,27523,1,31,27290,5397
12,233,27290,27523,-1,31,27523,13589
12,64,27523,27587,1,8,27523,5398
12,64,27523,27587,-1,8,27587,13590
12,176,27587,27763,1,3,27587,5399
12,176,27587,27763,-1,3,27763,13591
12,114,27763,27877,1,7,27763,5400
12,114,27763,27877,-1,7,27877,13592
12,141,27877,28018,1,112,27877,5401
12,141,27877,28018,-1,112,28018,13593
12,130,28018,28148,1,203,28018,5402
12,130,28018,28148,-1,203,28148,13594
12,133,28148,28281,1,79,28148,5403
12,133,28148,28281,-1,79,28281,13595
12,38,28281,28319,1,242,28281,5404
12,38,28281,28319,-1,242,28319,13596
12,169,28319,28488,1,143,28319,5405
12,169,28319,28488,-1,143,28488,13597
12,68,28488,28556,1,244,28488,5406
12,68,28488,28556,-1,244,28556,13598
12,223,28556,28779,1,100,28556,5407
12,223,28556,28779,-1,100,28779,13599
12,124,28779,28903,1,156,28779,5408
12,124,28779,28903,-1,156,28903,13600
12,153,28903,29056,1,241,28903,5409
12,153,28903,29056,-1,241,29056,13601
12,49,29056,29105,1,35,29056,5410
12,49,29056,29105,-1,35,29105,13602
12,184,29105,29289,1,115,29105,5411
12,184,29105,29289,-1,115,29289,13603
12,157,29289,29446,1,194,29289,5412
12,157,29289,29446,-1,194,29446,13604
12,98,29446,29544,1,108,29446,5413
12,98,29446,29544,-1,108,29544,13605
12,32,29544,29576,1,227,29544,5414
12,32,29544,29576,-1,227,29576,13606
12,123,29576,29699,1,84,29576,5415
12,123,29576,29699,-1,84,29699,13607
12,100,29699,29799,1,234,29699,5416
12,100,29699,29799,-1,234,29799,13608
12,60,29799,29859,1,148,29799,5417
12,60,29799,29859,-1,148,29859,13609
12,156,29859,30015,1,136,29859,5418
12,156,29859,30015,-1,136,30015,13610
12,58,30015,30073,1,121,30015,5419
12,58,30015,30073,-1,121,30073,13611
12,134,30073,30207,1,94,30073,5420
12,134,30073,30207,-1,94,30207,13612
12,42,30207,30249,1,110,30207,5421
12,42,30207,30249,-1,110,30249,13613
12,202,30249,30451,1,3,30249,5422
12,202,30249,30451,-1,3,30451,13614
12,77,30451,30528,1,49,30451,5423
12,77,30451,30528,-1,49,30528,13615
12,161,30528,30689,1,158,30528,5424
12,161,30528,30689,-1,158,30689,13616
12,195,30689,30884,1,65,30689,5425
12,195,30689,30884,-1,65,30884,13617
12,85,30884,30969,1,150,30884,5426
12,85,30884,30969,-1,150,30969,13618
12,74,30969,31043,1,250,30969,5427
12,74,30969,31043,-1,250,31043,13619
12,159,31043,31202,1,26,31043,5428
12,159,31043,31202,-1,26,31202,13620
13,70,0,70,1,190,0,2046
13,70,0,70,-1,190,70,10238
13,138,70,208,1,52,70,2047
13,138,70,208,-1,52,208,10239
13,72,208,280,1,66,208,2048
13,72,208,280,-1,66,280,10240
13,67,280,347,1,35,280,2049
13,67,280,347,-1,35,347,10241
13,177,347,524,1,156,347,2050
13,177,347,524,-1,156,524,10242
13,239,524,763,1,98,524,2051
13,239,524,763,-1,98,763,10243
13,166,763,929,1,124,763,2052
13,166,763,929,-1,124,929,10244
13,116,929,1045,1,173,929,2053
13,116,929,1045,-1,173,1045,10245
13,66,1045,1111,1,84,1045,2054
13,66,1045,1111,-1,84,1111,10246
13,127,1111,1238,1,101,1111,2055
13,127,1111,1238,-1,101,1238,10247
13,116,1238,1354,1,97,1238,2056
13,116,1238,1354,-1,97,1354,10248
13,300,1354,1654,1,127,1354,2057
13,300,1354,1654,-1,127,1654,10249
13,48,1654,1702,1,169,1654,2058
13,48,1654,1702,-1,169,1702,10250
13,55,1702,1757,1,94,1702,2059
13,55,1702,1757,-1,94,1757,10251
13,67,1757,1824,1,174,1757,2060
13,67,1757,1824,-1,174,1824,10252
13,72,1824,1896,1,174,1824,2061
13,72,1824,1896,-1,174,1896,10253
13,100,1896,1996,1,166,1896,2062
13,100,1896,1996,-1,166,1996,10254
13,103,1996,2099,1,20,1996,2063
13,103,1996,2099,-1,20,2099,10255
13,182,2099,2281,1,108,2099,2064
13,182,2099,2281,-1,108,2281,10256
13,77,2281,2358,1,2,2281,2065
13,77,2281,2358,-1,2,2358,10257
13,68,2358,2426,1,146,2358,2066
13,68,2358,2426,-1,146,2426,10258
13,108,2426,2534,1,90,2426,2067
13,108,2426,2534,-1,90,2534,10259
13,85,2534,2619,1,193,2534,2068
13,85,2534,2619,-1,193,2619,10260
13,176,2619,2795,1,137,2619,2069
13,176,2619,2795,-1,137,2795,10261
13,171,2795,2966,1,147,2795,2070
13,171,2795,2966,-1,147,2966,10262
13,78,2966,3044,1,247,2966,2071
13,78,2966,3044,-1,247,3044,10263
13,50,3044,3094,1,39,3044,2072
13,50,3044,3094,-1,39,3094,10264
13,131,3094,3225,1,104,3094,2073
13,131,3094,3225,-1,104,3225,10265
13,242,3225,3467,1,250,3225,2074
13,242,3225,3467,-1,250,3467,10266
13,62,3467,3529,1,146,3467,2075
13,62,3467,3529,-1,146,3529,10267
13,198,3529,3727,1,47,3529,2076
13,198,3529,3727,-1,47,3727,10268
13,157,3727,3884,1,197,3727,2077
13,157,3727,3884,-1,197,3884,10269
13,29,3884,3913,1,78,3884,2078
13,29,3884,3913,-1,78,3913,10270
13,80,3913,3993,1,132,3913,2079
13,80,3913,3993,-1,132,3993,10271
13,53,3993,4046,1,133,3993,2080
13,53,3993,4046,-1,133,4046,10272
13,217,4046,4263,1,11,4046,2081
13,217,4046,4263,-1,11,4263,10273
13,37,4263,4300,1,184,4263,2082
13,37,4263,4300,-1,184,4300,10274
13,308,4300,4608,1,117,4300,2083
13,308,4300,4608,-1,117,4608,10275
13,243,4608,4851,1,223,4608,2084
13,243,4608,4851,-1,223,4851,10276
13,32,4851,4883,1,179,4851,2085
13,32,4851,4883,-1,179,4883,10277
13,102,4883,4985,1,26,4883,2086
13,102,4883,4985,-1,26,4985,10278
13,115,4985,5100,1,161,4985,2087
13,115,4985,5100,-1,161,5100,10279
13,183,5100,5283,1,49,5100,2088
13,183,5100,5283,-1,49,5283,10280
13,146,5283,5429,1,14,5283,2089
13,146,5283,5429,-1,14,5429,10281
13,98,5429,5527,1,161,5429,2090
13,98,5429,5527,-1,161,5527,10282
13,139,5527,5666,1,87,5527,2091
13,139,5527,5666,-1,87,5666,10283
13,233,5666,5899,1,223,5666,2092
13,233,5666,5899,-1,223,5899,10284
13,72,5899,5971,1,86,5899,2093
13,72,5899,5971,-1,86,5971,10285
13,54,5971,6025,1,231,5971,2094
13,54,5971,6025,-1,231,6025,10286
13,66,6025,6091,1,58,6025,2095
13,66,6025,6091,-1,58,6091,10287
13,157,6091,6248,1,49,6091,2096
13,157,6091,6248,-1,49,6248,10288
13,68,6248,6316,1,206,6248,2097
13,68,6248,6316,-1,206,6316,10289
13,103,6316,6419,1,37,6316,2098
13,103,6316,6419,-1,37,6419,10290
13,115,6419,6534,1,225,6419,2099
13,115,6419,6534,-1,225,6534,10291
13,108,6534,6642,1,245,6534,2100
13,108,6534,6642,-1,245,6642,10292
13,89,6642,6731,1,44,6642,2101
13,89,6642,6731,-1,44,6731,10293
13,116,6731,6847,1,145,6731,2102
13,116,6731,6847,-1,145,6847,10294
13,160,6847,7007,1,108,6847,2103
13,160,6847,7007,-1,108,7007,10295
13,72,7007,7079,1,109,7007,2104
13,72,7007,7079,-1,109,7079,10296
13,98,7079,7177,1,205,7079,2105
13,98,7079,7177,-1,205,7177,10297
13,235,7177,7412,1,225,7177,2106
13,235,7177,7412,-1,225,7412,10298
13,111,7412,7523,1,214,7412,2107
13,111,7412,7523,-1,214,7523,10299
13,212,7523,7735,1,2,7523,2108
13,212,7523,7735,-1,2,7735,10300
13,84,7735,7819,1,223,7735,2109
13,84,7735,7819,-1,223,7819,10301
13,142,7819,7961,1,73,7819,2110
13,142,7819,7961,-1,73,7961,10302
13,64,7961,8025,1,134,7961,2111
13,64,7961,8025,-1,134,8025,10303
13,363,8025,8388,1,245,8025,2112
13,363,8025,8388,-1,245,8388,10304
13,62,8388,8450,1,126,8388,2113
13,62,8388,8450,-1,126,8450,10305
13,38,8450,8488,1,125,8450,2114
13,38,8450,8488,-1,125,8488,10306
13,48,8488,8536,1,68,8488,2115
13,48,8488,8536,-1,68,8536,10307
13,102,8536,8638,1,154,8536,2116
13,102,8536,8638,-1,154,8638,10308
13,221,8638,8859,1,49,8638,2117
13,221,8638,8859,-1,49,8859,10309
13,180,8859,9039,1,84,8859,2118
13,180,8859,9039,-1,84,9039,10310
13,190,9039,9229,1,193,9039,2119
13,190,9039,9229,-1,193,9229,10311
13,118,9229,9347,1,52,9229,2120
13,118,9229,9347,-1,52,9347,10312
13,231,9347,9578,1,187,9347,2121
13,231,9347,9578,-1,187,9578,10313
13,54,9578,9632,1,134,9578,2122
13,54,9578,9632,-1,134,9632,10314
13,122,9632,9754,1,244,9632,2123
13,122,9632,9754,-1,244,9754,10315
13,157,9754,9911,1,219,9754,2124
13,157,9754,9911,-1,219,9911,10316
13,129,9911,10040,1,217,9911,2125
13,129,9911,10040,-1,217,10040,10317
13,161,10040,10201,1,66,10040,2126
13,161,10040,10201,-1,66,10201,10318
13,181,10201,10382,1,93,10201,2127
13,181,10201,10382,-1,93,10382,10319
13,175,10382,10557,1,195,10382,2128
13,175,10382,10557,-1,195,10557,10320
13,41,10557,10598,1,226,10557,2129
13,41,10557,10598,-1,226,10598,10321
13,149,10598,10747,1,227,10598,2130
13,149,10598,10747,-1,227,10747,10322
13,74,10747,10821,1,96,10747,2131
13,74,10747,10821,-1,96,10821,10323
13,131,10821,10952,1,193,10821,2132
13,131,10821,10952,-1,193,10952,10324
13,104,10952,11056,1,26,10952,2133
13,104,10952,11056,-1,26,11056,10325
13,77,11056,11133,1,36,11056,2134
13,77,11056,11133,-1,36,11133,10326
13,90,11133,11223,1,137,11133,2135
13,90,11133,11223,-1,137,11223,10327
13,222,11223,11445,1,122,11223,2136
13,222,11223,11445,-1,122,11445,10328
13,62,11445,11507,1,117,11445,2137
13,62,11445,11507,-1,117,11507,10329
13,190,11507,11697,1,10,11507,2138
13,190,11507,11697,-1,10,11697,10330
13,151,11697,11848,1,100,11697,2139
13,151,11697,11848,-1,100,11848,10331
13,25,11848,11873,1,207,11848,2140
13,25,11848,11873,-1,207,11873,10332
13,239,11873,12112,1,121,11873,2141
13,239,11873,12112,-1,121,12112,10333
13,215,12112,12327,1,69,12112,2142
13,215,12112,12327,-1,69,12327,10334
13,91,12327,12418,1,186,12327,2143
13,91,12327,12418,-1,186,12418,10335
13,116,12418,12534,1,14,12418,2144
13,116,12418,12534,-1,14,12534,10336
13,137,12534,12671,1,123,12534,2145
13,137,12534,12671,-1,123,12671,10337
13,103,12671,12774,1,222,12671,2146
13,103,12671,12774,-1,222,12774,10338
13,111,12774,12885,1,156,12774,2147
13,111,12774,12885,-1,156,12885,10339
13,168,12885,13053,1,133,12885,2148
13,168,12885,13053,-1,133,13053,10340
13,95,13053,13148,1,162,13053,2149
13,95,13053,13148,-1,162,13148,10341
13,55,13148,13203,1,123,13148,2150
13,55,13148,13203,-1,123,13203,10342
13,122,13203,13325,1,149,13203,2151
13,122,13203,13325,-1,149,13325,10343
13,123,13325,13448,1,178,13325,2152
13,123,13325,13448,-1,178,13448,10344
13,122,13448,13570,1,7,13448,2153
13,122,13448,13570,-1,7,13570,10345
13,83,13570,13653,1,63,13570,2154
13,83,13570,13653,-1,63,13653,10346
13,116,13653,13769,1,12,13653,2155
13,116,13653,13769,-1,12,13769,10347
13,144,13769,13913,1,26,13769,2156
13,144,13769,13913,-1,26,13913,10348
13,149,13913,14062,1,153,13913,2157
13,149,13913,14062,-1,153,14062,10349
13,109,14062,14171,1,222,14062,2158
13,109,14062,14171,-1,222,14171,10350
13,57,14171,14228,1,172,14171,2159
13,57,14171,14228,-1,172,14228,10351
13,121,14228,14349,1,98,14228,2160
13,121,14228,14349,-1,98,14349,10352
13,137,14349,14486,1,66,14349,2161
13,137,14349,14486,-1,66,14486,10353
13,138,14486,14624,1,10,14486,2162
13,138,14486,14624,-1,10,14624,10354
13,90,14624,14714,1,83,14624,2163
13,90,14624,14714,-1,83,14714,10355
13,131,14714,14845,1,168,14714,2164
13,131,14714,14845,-1,168,14845,10356
13,195,14845,15040,1,189,14845,2165
13,195,14845,15040,-1,189,15040,10357
13,147,15040,15187,1,165,15040,2166
13,147,15040,15187,-1,165,15187,10358
13,97,15187,15284,1,41,15187,2167
13,97,15187,15284,-1,41,15284,10359
13,183,15284,15467,1,126,15284,2168
13,183,15284,15467,-1,126,15467,10360
13,197,15467,15664,1,91,15467,2169
13,197,15467,15664,-1,91,15664,10361
13,92,15664,15756,1,13,15664,2170
13,92,15664,15756,-1,13,15756,10362
13,60,15756,15816,1,58,15756,2171
13,60,15756,15816,-1,58,15816,10363
13,144,15816,15960,1,65,15816,2172
13,144,15816,15960,-1,65,15960,10364
13,83,15960,16043,1,126,15960,2173
13,83,15960,16043,-1,126,16043,10365
13,84,16043,16127,1,169,16043,2174
13,84,16043,16127,-1,169,16127,10366
13,93,16127,16220,1,88,16127,2175
13,93,16127,16220,-1,88,16220,10367
13,158,16220,16378,1,145,16220,2176
13,158,16220,16378,-1,145,16378,10368
13,96,16378,16474,1,177,16378,2177
13,96,16378,16474,-1,177,16474,10369
13,175,16474,16649,1,210,16474,2178
13,175,16474,16649,-1,210,16649,10370
13,95,16649,16744,1,57,16649,2179
13,95,16649,16744,-1,57,16744,10371
13,145,16744,16889,1,117,16744,2180
13,145,16744,16889,-1,117,16889,10372
13,35,16889,16924,1,20,16889,2181
13,35,16889,16924,-1,20,16924,10373
13,175,16924,17099,1,63,16924,2182
13,175,16924,17099,-1,63,17099,10374
13,91,17099,17190,1,124,17099,2183
13,91,17099,17190,-1,124,17190,10375
13,108,17190,17298,1,239,17190,2184
13,108,17190,17298,-1,239,17298,10376
13,99,17298,17397,1,105,17298,2185
13,99,17298,17397,-1,105,17397,10377
13,209,17397,17606,1,134,17397,2186
13,209,17397,17606,-1,134,17606,10378
13,71,17606,17677,1,152,17606,2187
13,71,17606,17677,-1,152,17677,10379
13,170,17677,17847,1,167,17677,2188
13,170,17677,17847,-1,167,17847,10380
13,91,17847,17938,1,98,17847,2189
13,91,17847,17938,-1,98,17938,10381
13,110,17938,18048,1,7,17938,2190
13,110,17938,18048,-1,7,18048,10382
13,161,18048,18209,1,138,18048,2191
13,161,18048,18209,-1,138,18209,10383
13,116,18209,18325,1,161,18209,2192
13,116,18209,18325,-1,161,18325,10384
13,65,18325,18390,1,95,18325,2193
13,65,18325,18390,-1,95,18390,10385
13,139,18390,18529,1,223,18390,2194
13,139,18390,18529,-1,223,18529,10386
13,34,18529,18563,1,20,18529,2195
13,34,18529,18563,-1,20,18563,10387
13,180,18563,18743,1,148,18563,2196
13,180,18563,18743,-1,148,18743,10388
13,66,18743,18809,1,72,18743,2197
13,66,18743,18809,-1,72,18809,10389
13,153,18809,18962,1,160,18809,2198
13,153,18809,18962,-1,160,18962,10390
13,74,18962,19036,1,5,18962,2199
13,74,18962,19036,-1,5,19036,10391
13,125,19036,19161,1,76,19036,2200
13,125,19036,19161,-1,76,19161,10392
13,36,19161,19197,1,136,19161,2201
13,36,19161,19197,-1,136,19197,10393
13,90,19197,19287,1,42,19197,2202
13,90,19197,19287,-1,42,19287,10394
13,173,19287,19460,1,25,19287,2203
13,173,19287,19460,-1,25,19460,10395
13,202,19460,19662,1,179,19460,2204
13,202,19460,19662,-1,179,19662,10396
13,145,19662,19807,1,131,19662,2205
13,145,19662,19807,-1,131,19807,10397
13,190,19807,19997,1,158,19807,2206
13,190,19807,19997,-1,158,19997,10398
13,66,19997,20063,1,184,19997,2207
13,66,19997,20063,-1,184,20063,10399
13,71,20063,20134,1,40,20063,2208
13,71,20063,20134,-1,40,20134,10400
13,44,20134,20178,1,21,20134,2209
13,44,20134,20178,-1,21,20178,10401
13,148,20178,20326,1,124,20178,2210
13,148,20178,20326,-1,124,20326,10402
13,193,20326,20519,1,238,20326,2211
13,193,20326,20519,-1,238,20519,10403
13,117,20519,20636,1,177,20519,2212
13,117,20519,20636,-1,177,20636,10404
13,62,20636,20698,1,186,20636,2213
13,62,20636,20698,-1,186,20698,10405
13,179,20698,20877,1,85,20698,2214
13,179,20698,20877,-1,85,20877,10406
13,326,20877,21203,1,212,20877,2215
13,326,20877,21203,-1,212,21203,10407
13,131,21203,21334,1,136,21203,2216
13,131,21203,21334,-1,136,21334,10408
13,140,21334,21474,1,114,21334,2217
13,140,21334,21474,-1,114,21474,10409
13,96,21474,21570,1,41,21474,2218
13,96,21474,21570,-1,41,21570,10410
13,275,21570,21845,1,237,21570,2219
13,275,21570,21845,-1,237,21845,10411
13,136,21845,21981,1,197,21845,2220
13,136,21845,21981,-1,197,21981,10412
13,125,21981,22106,1,55,21981,2221
13,125,21981,22106,-1,55,22106,10413
13,26,22106,22132,1,179,22106,2222
13,26,22106,22132,-1,179,22132,10414
13,49,22132,22181,1,33,22132,2223
13,49,22132,22181,-1,33,22181,10415
13,194,22181,22375,1,139,22181,2224
13,194,22181,22375,-1,139,22375,10416
13,70,22375,22445,1,50,22375,2225
13,70,22375,22445,-1,50,22445,10417
13,99,22445,22544,1,149,22445,2226
13,99,22445,22544,-1,149,22544,10418
13,52,22544,22596,1,76,22544,2227
13,52,22544,22596,-1,76,22596,10419
13,92,22596,22688,1,143,22596,2228
13,92,22596,22688,-1,143,22688,10420
13,69,22688,22757,1,229,22688,2229
13,69,22688,22757,-1,229,22757,10421
13,138,22757,22895,1,95,22757,2230
13,138,22757,22895,-1,95,22895,10422
13,149,22895,23044,1,170,22895,2231
13,149,22895,23044,-1,170,23044,10423
13,180,23044,23224,1,111,23044,2232
13,180,23044,23224,-1,111,23224,10424
13,95,23224,23319,1,81,23224,2233
13,95,23224,23319,-1,81,23319,10425
13,82,23319,23401,1,69,23319,2234
13,82,23319,23401,-1,69,23401,10426
13,274,23401,23675,1,180,23401,2235
13,274,23401,23675,-1,180,23675,10427
13,92,23675,23767,1,197,23675,2236
13,92,23675,23767,-1,197,23767,10428
13,295,23767,24062,1,186,23767,2237
13,295,23767,24062,-1,186,24062,10429
13,155,24062,24217,1,95,24062,2238
13,155,24062,24217,-1,95,24217,10430
13,183,24217,24400,1,93,24217,2239
13,183,24217,24400,-1,93,24400,10431
13,151,24400,24551,1,223,24400,2240
13,151,24400,24551,-1,223,24551,10432
13,145,24551,24696,1,195,24551,2241
13,145,24551,24696,-1,195,24696,10433
13,79,24696,24775,1,72,24696,2242
13,79,24696,24775,-1,72,24775,10434
13,81,24775,24856,1,5,24775,2243
13,81,24775,24856,-1,5,24856,10435
13,99,24856,24955,1,83,24856,2244
13,99,24856,24955,-1,83,24955,10436
13,126,24955,25081,1,216,24955,2245
13,126,24955,25081,-1,216,25081,10437
13,92,25081,25173,1,57,25081,2246
13,92,25081,25173,-1,57,25173,10438
13,97,25173,25270,1,34,25173,2247
13,97,25173,25270,-1,34,25270,10439
13,76,25270,25346,1,123,25270,2248
13,76,25270,25346,-1,123,25346,10440
13,102,25346,25448,1,26,25346,2249
13,102,25346,25448,-1,26,25448,10441
13,245,25448,25693,1,126,25448,2250
13,245,25448,25693,-1,126,25693,10442
13,96,25693,25789,1,30,25693,2251
13,96,25693,25789,-1,30,25789,10443
13,66,25789,25855,1,197,25789,2252
13,66,25789,25855,-1,197,25855,10444
13,186,25855,26041,1,186,25855,2253
13,186,25855,26041,-1,186,26041,10445
13,85,26041,26126,1,182,26041,2254
13,85,26041,26126,-1,182,26126,10446
13,100,26126,26226,1,22,26126,2255
13,100,26126,26226,-1,22,26226,10447
13,136,26226,26362,1,222,26226,2256
13,136,26226,26362,-1,222,26362,10448
13,92,26362,26454,1,142,26362,2257
13,92,26362,26454,-1,142,26454,10449
13,71,26454,26525,1,6,26454,2258
13,71,26454,26525,-1,6,26525,10450
13,37,26525,26562,1,35,26525,2259
13,37,26525,26562,-1,35,26562,10451
13,264,26562,26826,1,7,26562,2260
13,264,26562,26826,-1,7,26826,10452
13,184,26826,27010,1,91,26826,2261
13,184,26826,27010,-1,91,27010,10453
13,60,27010,27070,1,110,27010,2262
13,60,27010,27070,-1,110,27070,10454
13,76,27070,27146,1,85,27070,2263
13,76,27070,27146,-1,85,27146,10455
13,137,27146,27283,1,223,27146,2264
13,137,27146,27283,-1,223,27283,10456
13,91,27283,27374,1,165,27283,2265
13,91,27283,27374,-1,165,27374,10457
13,133,27374,27507,1,30,27374,2266
13,133,27374,27507,-1,30,27507,10458
13,232,27507,27739,1,116,27507,2267
13,232,27507,27739,-1,116,27739,10459
13,106,27739,27845,1,46,27739,2268
13,106,27739,27845,-1,46,27845,10460
13,54,27845,27899,1,30,27845,2269
13,54,27845,27899,-1,30,27899,10461
13,231,27899,28130,1,174,27899,2270
13,231,27899,28130,-1,174,28130,10462
13,205,28130,28335,1,14,28130,2271
13,205,28130,28335,-1,14,28335,10463
13,98,28335,28433,1,102,28335,2272
13,98,28335,28433,-1,102,28433,10464
13,78,28433,28511,1,180,28433,2273
13,78,28433,28511,-1,180,28511,10465
13,71,28511,28582,1,131,28511,2274
13,71,28511,28582,-1,131,28582,10466
13,231,28582,28813,1,33,28582,2275
13,231,28582,28813,-1,33,28813,10467
13,49,28813,28862,1,239,28813,2276
13,49,28813,28862,-1,239,28862,10468
13,299,28862,29161,1,112,28862,2277
13,299,28862,29161,-1,112,29161,10469
13,161,29161,29322,1,157,29161,2278
13,161,29161,29322,-1,157,29322,10470
13,115,29322,29437,1,99,29322,2279
13,115,29322,29437,-1,99,29437,10471
13,139,29437,29576,1,168,29437,2280
13,139,29437,29576,-1,168,29576,10472
13,94,29576,29670,1,238,29576,2281
13,94,29576,29670,-1,238,29670,10473
13,131,29670,29801,1,160,29670,2282
13,131,29670,29801,-1,160,29801,10474
13,71,29801,29872,1,96,29801,2283
13,71,29801,29872,-1,96,29872,10475
13,100,29872,29972,1,199,29872,2284
13,100,29872,29972,-1,199,29972,10476
13,55,29972,30027,1,146,29972,2285
13,55,29972,30027,-1,146,30027,10477
13,254,30027,30281,1,198,30027,2286
13,254,30027,30281,-1,198,30281,10478
13,240,30281,30521,1,246,30281,2287
13,240,30281,30521,-1,246,30521,10479
13,187,30521,30708,1,122,30521,2288
13,187,30521,30708,-1,122,30708,10480
13,194,30708,30902,1,190,30708,2289
13,194,30708,30902,-1,190,30902,10481
13,141,30902,31043,1,133,30902,2290
13,141,30902,31043,-1,133,31043,10482
13,87,31043,31130,1,165,31043,2291
13,87,31043,31130,-1,165,31130,10483
13,133,31130,31263,1,113,31130,2292
13,133,31130,31263,-1,113,31263,10484
13,67,31263,31330,1,23,31263,2293
13,67,31263,31330,-1,23,31330,10485
13,48,31330,31378,1,137,31330,2294
13,48,31330,31378,-1,137,31378,10486
13,62,31378,31440,1,140,31378,2295
13,62,31378,31440,-1,140,31440,10487
13,90,31440,31530,1,156,31440,2296
13,90,31440,31530,-1,156,31530,10488
13,35,31530,31565,1,54,31530,2297
13,35,31530,31565,-1,54,31565,10489
13,137,31565,31702,1,47,31565,2298
13,137,31565,31702,-1,47,31702,10490
13,84,31702,31786,1,73,31702,2299
13,84,31702,31786,-1,73,31786,10491
13,120,31786,31906,1,1,31786,2300
13,120,31786,31906,-1,1,31906,10492
13,98,31906,32004,1,46,31906,2301
13,98,31906,32004,-1,46,32004,10493
13,149,32004,32153,1,84,32004,2302
13,149,32004,32153,-1,84,32153,10494
13,219,32153,32372,1,184,32153,2303
13,219,32153,32372,-1,184,32372,10495
13,76,32372,32448,1,68,32372,2304
13,76,32372,32448,-1,68,32448,10496
13,102,32448,32550,1,215,32448,2305
13,102,32448,32550,-1,215,32550,10497
13,141,32550,32691,1,11,32550,2306
13,141,32550,32691,-1,11,32691,10498
13,139,32691,32830,1,238,32691,2307
13,139,32691,32830,-1,238,32830,10499
13,338,32830,33168,1,111,32830,2308
13,338,32830,33168,-1,111,33168,10500
14,120,0,120,1,201,0,2576
14,120,0,120,-1,201,120,10768
14,35,120,155,1,158,120,2577
14,35,120,155,-1,158,155,10769
14,205,155,360,1,94,155,2578
14,205,155,360,-1,94,360,10770
14,132,360,492,1,203,360,2579
14,132,360,492,-1,203,492,10771
14,40,492,532,1,106,492,2580
14,40,492,532,-1,106,532,10772
14,77,532,609,1,88,532,2581
14,77,532,609,-1,88,609,10773
14,57,609,666,1,210,609,2582
14,57,609,666,-1,210,666,10774
14,103,666,769,1,5,666,2583
14,103,666,769,-1,5,769,10775
14,64,769,833,1,3,769,2584
14,64,769,833,-1,3,833,10776
14,293,833,1126,1,2,833,2585
14,293,833,1126,-1,2,1126,10777
14,120,1126,1246,1,103,1126,2586
14,120,1126,1246,-1,103,1246,10778
14,240,1246,1486,1,76,1246,2587
14,240,1246,1486,-1,76,1486,10779
14,206,1486,1692,1,21,1486,2588
14,206,1486,1692,-1,21,1692,10780
14,92,1692,1784,1,10,1692,2589
14,92,1692,1784,-1,10,1784,10781
14,101,1784,1885,1,76,1784,2590
14,101,1784,1885,-1,76,1885,10782
14,123,1885,2008,1,201,1885,2591
14,123,1885,2008,-1,201,2008,10783
14,66,2008,2074,1,62,2008,2592
14,66,2008,2074,-1,62,2074,10784
14,148,2074,2222,1,25,2074,2593
14,148,2074,2222,-1,25,2222,10785
14,172,2222,2394,1,227,2222,2594
14,172,2222,2394,-1,227,2394,10786
14,153,2394,2547,1,224,2394,2595
14,153,2394,2547,-1,224,2547,10787
14,282,2547,2829,1,80,2547,2596
14,282,2547,2829,-1,80,2829,10788
14,28,2829,2857,1,247,2829,2597
14,28,2829,2857,-1,247,2857,10789
14,44,2857,2901,1,38,2857,2598
14,44,2857,2901,-1,38,2901,10790
14,136,2901,3037,1,51,2901,2599
14,136,2901,3037,-1,51,3037,10791
14,76,3037,3113,1,172,3037,2600
14,76,3037,3113,-1,172,3113,10792
14,307,3113,3420,1,182,3113,2601
14,307,3113,3420,-1,182,3420,10793
14,50,3420,3470,1,59,3420,2602
14,50,3420,3470,-1,59,3470,10794
14,137,3470,3607,1,137,3470,2603
14,137,3470,3607,-1,137,3607,10795
14,136,3607,3743,1,229,3607,2604
14,136,3607,3743,-1,229,3743,10796
14,67,3743,3810,1,47,3743,2605
14,67,3743,3810,-1,47,3810,10797
14,187,3810,3997,1,224,3810,2606
14,187,3810,3997,-1,224,3997,10798
14,190,3997,4187,1,191,3997,2607
14,190,3997,4187,-1,191,4187,10799
14,185,4187,4372,1,130,4187,2608
14,185,4187,4372,-1,130,4372,10800
14,141,4372,4513,1,229,4372,2609
14,141,4372,4513,-1,229,4513,10801
14,89,4513,4602,1,252,4513,2610
14,89,4513,4602,-1,252,4602,10802
14,133,4602,4735,1,50,4602,2611
14,133,4602,4735,-1,50,4735,10803
14,89,4735,4824,1,25,4735,2612
14,89,4735,4824,-1,25,4824,10804
14,97,4824,4921,1,213,4824,2613
14,97,4824,4921,-1,213,4921,10805
14,149,4921,5070,1,76,4921,2614
14,149,4921,5070,-1,76,5070,10806
14,166,5070,5236,1,76,5070,2615
14,166,5070,5236,-1,76,5236,10807
14,107,5236,5343,1,190,5236,2616
14,107,5236,5343,-1,190,5343,10808
14,100,5343,5443,1,66,5343,2617
14,100,5343,5443,-1,66,5443,10809
14,40,5443,5483,1,185,5443,2618
14,40,5443,5483,-1,185,5483,10810
14,69,5483,5552,1,43,5483,2619
14,69,5483,5552,-1,43,5552,10811
14,53,5552,5605,1,235,5552,2620
14,53,5552,5605,-1,235,5605,10812
14,54,5605,5659,1,84,5605,2621
14,54,5605,5659,-1,84,5659,10813
14,98,5659,5757,1,233,5659,2622
14,98,5659,5757,-1,233,5757,10814
14,196,5757,5953,1,37,5757,2623
14,196,5757,5953,-1,37,5953,10815
14,54,5953,6007,1,241,5953,2624
14,54,5953,6007,-1,241,6007,10816
14,155,6007,6162,1,64,6007,2625
14,155,6007,6162,-1,64,6162,10817
14,30,6162,6192,1,73,6162,2626
14,30,6162,6192,-1,73,6192,10818
14,174,6192,6366,1,145,6192,2627
14,174,6192,6366,-1,145,6366,10819
14,170,6366,6536,1,224,6366,2628
14,170,6366,6536,-1,224,6536,10820
14,84,6536,6620,1,34,6536,2629
14,84,6536,6620,-1,34,6620,10821
14,100,6620,6720,1,38,6620,2630
14,100,6620,6720,-1,38,6720,10822
14,118,6720,6838,1,98,6720,2631
14,118,6720,6838,-1,98,6838,10823
14,77,6838,6915,1,192,6838,2632
14,77,6838,6915,-1,192,6915,10824
14,125,6915,7040,1,179,6915,2633
14,125,6915,7040,-1,179,7040,10825
14,115,7040,7155,1,159,7040,2634
14,115,7040,7155,-1,159,7155,10826
14,87,7155,7242,1,141,7155,2635
14,87,7155,7242,-1,141,7242,10827
14,155,7242,7397,1,248,7242,2636
14,155,7242,7397,-1,248,7397,10828
14,108,7397,7505,1,145,7397,2637
14,108,7397,7505,-1,145,7505,10829
14,190,7505,7695,1,108,7505,2638
14,190,7505,7695,-1,108,7695,10830
14,171,7695,7866,1,97,7695,2639
14,171,7695,7866,-1,97,7866,10831
14,176,7866,8042,1,200,7866,2640
14,176,7866,8042,-1,200,8042,10832
14,87,8042,8129,1,100,8042,2641
14,87,8042,8129,-1,100,8129,10833
14,100,8129,8229,1,128,8129,2642
14,100,8129,8229,-1,128,8229,10834
14,267,8229,8496,1,7,8229,2643
14,267,8229,8496,-1,7,8496,10835
14,103,8496,8599,1,57,8496,2644
14,103,8496,8599,-1,57,8599,10836
14,153,8599,8752,1,159,8599,2645
14,153,8599,8752,-1,159,8752,10837
14,193,8752,8945,1,51,8752,2646
14,193,8752,8945,-1,51,8945,10838
14,119,8945,9064,1,141,8945,2647
14,119,8945,9064,-1,141,9064,10839
14,59,9064,9123,1,243,9064,2648
14,59,9064,9123,-1,243,9123,10840
14,97,9123,9220,1,91,9123,2649
14,97,9123,9220,-1,91,9220,10841
14,86,9220,9306,1,22,9220,2650
14,86,9220,9306,-1,22,9306,10842
14,209,9306,9515,1,231,9306,2651
14,209,9306,9515,-1,231,9515,10843
14,183,9515,9698,1,191,9515,2652
14,183,9515,9698,-1,191,9698,10844
14,153,9698,9851,1,219,9698,2653
14,153,9698,9851,-1,219,9851,10845
14,54,9851,9905,1,9,9851,2654
14,54,9851,9905,-1,9,9905,10846
14,111,9905,10016,1,183,9905,2655
14,111,9905,10016,-1,183,10016,10847
14,321,10016,10337,1,15,10016,2656
14,321,10016,10337,-1,15,10337,10848
14,43,10337,10380,1,163,10337,2657
14,43,10337,10380,-1,163,10380,10849
14,194,10380,10574,1,54,10380,2658
14,194,10380,10574,-1,54,10574,10850
14,104,10574,10678,1,128,10574,2659
14,104,10574,10678,-1,128,10678,10851
14,149,10678,10827,1,147,10678,2660
14,149,10678,10827,-1,147,10827,10852
14,8,10827,10835,1,237,10827,2661
14,8,10827,10835,-1,237,10835,10853
14,107,10835,10942,1,43,10835,2662
14,107,10835,10942,-1,43,10942,10854
14,165,10942,11107,1,107,10942,2663
14,165,10942,11107,-1,107,11107,10855
14,119,11107,11226,1,1,11107,2664
14,119,11107,11226,-1,1,11226,10856
14,87,11226,11313,1,24,11226,2665
14,87,11226,11313,-1,24,11313,10857
14,173,11313,11486,1,71,11313,2666
14,173,11313,11486,-1,71,11486,10858
14,102,11486,11588,1,40,11486,2667
14,102,11486,11588,-1,40,11588,10859
14,162,11588,11750,1,181,11588,2668
14,162,11588,11750,-1,181,11750,10860
14,119,11750,11869,1,68,11750,2669
14,119,11750,11869,-1,68,11869,10861
14,99,11869,11968,1,77,11869,2670
14,99,11869,11968,-1,77,11968,10862
14,179,11968,12147,1,251,11968,2671
14,179,11968,12147,-1,251,12147,10863
14,64,12147,12211,1,58,12147,2672
14,64,12147,12211,-1,58,12211,10864
14,54,12211,12265,1,64,12211,2673
14,54,12211,12265,-1,64,12265,10865
14,89,12265,12354,1,252,12265,2674
14,89,12265,12354,-1,252,12354,10866
14,209,12354,12563,1,140,12354,2675
14,209,12354,12563,-1,140,12563,10867
14,123,12563,12686,1,203,12563,2676
14,123,12563,12686,-1,203,12686,10868
14,58,12686,12744,1,145,12686,2677
14,58,12686,12744,-1,145,12744,10869
14,101,12744,12845,1,110,12744,2678
14,101,12744,12845,-1,110,12845,10870
14,134,12845,12979,1,107,12845,2679
14,134,12845,12979,-1,107,12979,10871
14,76,12979,13055,1,107,12979,2680
14,76,12979,13055,-1,107,13055,10872
14,202,13055,13257,1,5,13055,2681
14,202,13055,13257,-1,5,13257,10873
14,117,13257,13374,1,209,13257,2682
14,117,13257,13374,-1,209,13374,10874
14,184,13374,13558,1,132,13374,2683
14,184,13374,13558,-1,132,13558,10875
14,147,13558,13705,1,157,13558,2684
14,147,13558,13705,-1,157,13705,10876
14,196,13705,13901,1,152,13705,2685
14,196,13705,13901,-1,152,13901,10877
14,197,13901,14098,1,161,13901,2686
14,197,13901,14098,-1,161,14098,10878
14,276,14098,14374,1,193,14098,2687
14,276,14098,14374,-1,193,14374,10879
14,185,14374,14559,1,53,14374,2688
14,185,14374,14559,-1,53,14559,10880
14,285,14559,14844,1,242,14559,2689
14,285,14559,14844,-1,242,14844,10881
14,97,14844,14941,1,95,14844,2690
14,97,14844,14941,-1,95,14941,10882
14,48,14941,14989,1,223,14941,2691
14,48,14941,14989,-1,223,14989,10883
14,185,14989,15174,1,216,14989,2692
14,185,14989,15174,-1,216,15174,10884
14,126,15174,15300,1,173,15174,2693
14,126,15174,15300,-1,173,15300,10885
14,85,15300,15385,1,18,15300,2694
14,85,15300,15385,-1,18,15385,10886
14,44,15385,15429,1,202,15385,2695
14,44,15385,15429,-1,202,15429,10887
14,117,15429,15546,1,109,15429,2696
14,117,15429,15546,-1,109,15546,10888
14,127,15546,15673,1,113,15546,2697
14,127,15546,15673,-1,113,15673,10889
14,129,15673,15802,1,22,15673,2698
14,129,15673,15802,-1,22,15802,10890
14,191,15802,15993,1,29,15802,2699
14,191,15802,15993,-1,29,15993,10891
14,119,15993,16112,1,27,15993,2700
14,119,15993,16112,-1,27,16112,10892
14,121,16112,16233,1,244,16112,2701
14,121,16112,16233,-1,244,16233,10893
14,83,16233,16316,1,13,16233,2702
14,83,16233,16316,-1,13,16316,10894
14,189,16316,16505,1,9,16316,2703
14,189,16316,16505,-1,9,16505,10895
14,134,16505,16639,1,80,16505,2704
14,134,16505,16639,-1,80,16639,10896
14,113,16639,16752,1,37,16639,2705
14,113,16639,16752,-1,37,16752,10897
14,64,16752,16816,1,58,16752,2706
14,64,16752,16816,-1,58,16816,10898
14,120,16816,16936,1,187,16816,2707
14,120,16816,16936,-1,187,16936,10899
14,265,16936,17201,1,209,16936,2708
14,265,16936,17201,-1,209,17201,10900
14,78,17201,17279,1,147,17201,2709
14,78,17201,17279,-1,147,17279,10901
14,70,17279,17349,1,214,17279,2710
14,70,17279,17349,-1,214,17349,10902
14,133,17349,17482,1,61,17349,2711
14,133,17349,17482,-1,61,17482,10903
14,59,17482,17541,1,120,17482,2712
14,59,17482,17541,-1,120,17541,10904
14,113,17541,17654,1,3,17541,2713
14,113,17541,17654,-1,3,17654,10905
14,241,17654,17895,1,239,17654,2714
14,241,17654,17895,-1,239,17895,10906
14,89,17895,17984,1,132,17895,2715
14,89,17895,17984,-1,132,17984,10907
14,172,17984,18156,1,115,17984,2716
14,172,17984,18156,-1,115,18156,10908
14,58,18156,18214,1,115,18156,2717
14,58,18156,18214,-1,115,18214,10909
14,137,18214,18351,1,237,18214,2718
14,137,18214,18351,-1,237,18351,10910
14,132,18351,18483,1,44,18351,2719
14,132,18351,18483,-1,44,18483,10911
14,36,18483,18519,1,165,18483,2720
14,36,18483,18519,-1,165,18519,10912
14,61,18519,18580,1,172,18519,2721
14,61,18519,18580,-1,172,18580,10913
14,105,18580,18685,1,87,18580,2722
14,105,18580,18685,-1,87,18685,10914
14,99,18685,18784,1,163,18685,2723
14,99,18685,18784,-1,163,18784,10915
14,116,18784,18900,1,106,18784,2724
14,116,18784,18900,-1,106,18900,10916
14,166,18900,19066,1,107,18900,2725
14,166,18900,19066,-1,107,19066,10917
14,116,19066,19182,1,38,19066,2726
14,116,19066,19182,-1,38,19182,10918
14,159,19182,19341,1,188,19182,2727
14,159,19182,19341,-1,188,19341,10919
14,60,19341,19401,1,189,19341,2728
14,60,19341,19401,-1,189,19401,10920
14,196,19401,19597,1,68,19401,2729
14,196,19401,19597,-1,68,19597,10921
14,152,19597,19749,1,211,19597,2730
14,152,19597,19749,-1,211,19749,10922
14,195,19749,19944,1,101,19749,2731
14,195,19749,19944,-1,101,19944,10923
14,106,19944,20050,1,87,19944,2732
14,106,19944,20050,-1,87,20050,10924
14,103,20050,20153,1,125,20050,2733
14,103,20050,20153,-1,125,20153,10925
14,194,20153,20347,1,118,20153,2734
14,194,20153,20347,-1,118,20347,10926
14,175,20347,20522,1,130,20347,2735
14,175,20347,20522,-1,130,20522,10927
14,42,20522,20564,1,114,20522,2736
14,42,20522,20564,-1,114,20564,10928
14,74,20564,20638,1,227,20564,2737
14,74,20564,20638,-1,227,20638,10929
14,107,20638,20745,1,230,20638,2738
14,107,20638,20745,-1,230,20745,10930
14,110,20745,20855,1,29,20745,2739
14,110,20745,20855,-1,29,20855,10931
14,271,20855,21126,1,47,20855,2740
14,271,20855,21126,-1,47,21126,10932
14,174,21126,21300,1,7,21126,2741
14,174,21126,21300,-1,7,21300,10933
14,151,21300,21451,1,122,21300,2742
14,151,21300,21451,-1,122,21451,10934
14,129,21451,21580,1,107,21451,2743
14,129,21451,21580,-1,107,21580,10935
14,71,21580,21651,1,126,21580,2744
14,71,21580,21651,-1,126,21651,10936
14,100,21651,21751,1,58,21651,2745
14,100,21651,21751,-1,58,21751,10937
14,199,21751,21950,1,8,21751,2746
14,199,21751,21950,-1,8,21950,10938
14,57,21950,22007,1,145,21950,2747
14,57,21950,22007,-1,145,22007,10939
14,66,22007,22073,1,142,22007,2748
14,66,22007,22073,-1,142,22073,10940
14,104,22073,22177,1,73,22073,2749
14,104,22073,22177,-1,73,22177,10941
14,223,22177,22400,1,94,22177,2750
14,223,22177,22400,-1,94,22400,10942
14,99,22400,22499,1,201,22400,2751
14,99,22400,22499,-1,201,22499,10943
14,45,22499,22544,1,177,22499,2752
14,45,22499,22544,-1,177,22544,10944
14,145,22544,22689,1,26,22544,2753
14,145,22544,22689,-1,26,22689,10945
14,74,22689,22763,1,114,22689,2754
14,74,22689,22763,-1,114,22763,10946
14,48,22763,22811,1,141,22763,2755
14,48,22763,22811,-1,141,22811,10947
14,132,22811,22943,1,116,22811,2756
14,132,22811,22943,-1,116,22943,10948
14,169,22943,23112,1,106,22943,2757
14,169,22943,23112,-1,106,23112,10949
14,212,23112,23324,1,99,23112,2758
14,212,23112,23324,-1,99,23324,10950
14,105,23324,23429,1,169,23324,2759
14,105,23324,23429,-1,169,23429,10951
14,134,23429,23563,1,44,23429,2760
14,134,23429,23563,-1,44,23563,10952
14,118,23563,23681,1,124,23563,2761
14,118,23563,23681,-1,124,23681,10953
14,49,23681,23730,1,97,23681,2762
14,49,23681,23730,-1,97,23730,10954
14,59,23730,23789,1,192,23730,2763
14,59,23730,23789,-1,192,23789,10955
14,118,23789,23907,1,180,23789,2764
14,118,23789,23907,-1,180,23907,10956
14,61,23907,23968,1,242,23907,2765
14,61,23907,23968,-1,242,23968,10957
14,152,23968,24120,1,22,23968,2766
14,152,23968,24120,-1,22,24120,10958
14,72,24120,24192,1,173,24120,2767
14,72,24120,24192,-1,173,24192,10959
14,176,24192,24368,1,164,24192,2768
14,176,24192,24368,-1,164,24368,10960
14,145,24368,24513,1,76,24368,2769
14,145,24368,24513,-1,76,24513,10961
14,90,24513,24603,1,214,24513,2770
14,90,24513,24603,-1,214,24603,10962
14,107,24603,24710,1,92,24603,2771
14,107,24603,24710,-1,92,24710,10963
14,93,24710,24803,1,149,24710,2772
14,93,24710,24803,-1,149,24803,10964
14,187,24803,24990,1,149,24803,2773
14,187,24803,24990,-1,149,24990,10965
14,141,24990,25131,1,137,24990,2774
14,141,24990,25131,-1,137,25131,10966
14,85,25131,25216,1,57,25131,2775
14,85,25131,25216,-1,57,25216,10967
14,166,25216,25382,1,161,25216,2776
14,166,25216,25382,-1,161,25382,10968
14,142,25382,25524,1,43,25382,2777
14,142,25382,25524,-1,43,25524,10969
14,26,25524,25550,1,108,25524,2778
14,26,25524,25550,-1,108,25550,10970
14,96,25550,25646,1,9,25550,2779
14,96,25550,25646,-1,9,25646,10971
14,37,25646,25683,1,73,25646,2780
14,37,25646,25683,-1,73,25683,10972
14,89,25683,25772,1,226,25683,2781
14,89,25683,25772,-1,226,25772,10973
14,211,25772,25983,1,129,25772,2782
14,211,25772,25983,-1,129,25983,10974
14,214,25983,26197,1,17,25983,2783
14,214,25983,26197,-1,17,26197,10975
14,118,26197,26315,1,7,26197,2784
14,118,26197,26315,-1,7,26315,10976
14,146,26315,26461,1,133,26315,2785
14,146,26315,26461,-1,133,26461,10977
14,209,26461,26670,1,85,26461,2786
14,209,26461,26670,-1,85,26670,10978
14,133,26670,26803,1,241,26670,2787
14,133,26670,26803,-1,241,26803,10979
14,16,26803,26819,1,146,26803,2788
14,16,26803,26819,-1,146,26819,10980
14,125,26819,26944,1,151,26819,2789
14,125,26819,26944,-1,151,26944,10981
14,35,26944,26979,1,165,26944,2790
14,35,26944,26979,-1,165,26979,10982
14,124,26979,27103,1,4,26979,2791
14,124,26979,27103,-1,4,27103,10983
14,107,27103,27210,1,50,27103,2792
14,107,27103,27210,-1,50,27210,10984
14,124,27210,27334,1,50,27210,2793
14,124,27210,27334,-1,50,27334,10985
14,140,27334,27474,1,113,27334,2794
14,140,27334,27474,-1,113,27474,10986
14,165,27474,27639,1,232,27474,2795
14,165,27474,27639,-1,232,27639,10987
14,19,27639,27658,1,87,27639,2796
14,19,27639,27658,-1,87,27658,10988
14,53,27658,27711,1,223,27658,2797
14,53,27658,27711,-1,223,27711,10989
14,170,27711,27881,1,99,27711,2798
14,170,27711,27881,-1,99,27881,10990
14,93,27881,27974,1,97,27881,2799
14,93,27881,27974,-1,97,27974,10991
14,261,27974,28235,1,122,27974,2800
14,261,27974,28235,-1,122,28235,10992
14,182,28235,28417,1,119,28235,2801
14,182,28235,28417,-1,119,28417,10993
14,83,28417,28500,1,27,28417,2802
14,83,28417,28500,-1,27,28500,10994
14,137,28500,28637,1,185,28500,2803
14,137,28500,28637,-1,185,28637,10995
14,116,28637,28753,1,25,28637,2804
14,116,28637,28753,-1,25,28753,10996
14,117,28753,28870,1,174,28753,2805
14,117,28753,28870,-1,174,28870,10997
14,213,28870,29083,1,63,28870,2806
14,213,28870,29083,-1,63,29083,10998
14,41,29083,29124,1,3,29083,2807
14,41,29083,29124,-1,3,29124,10999
14,123,29124,29247,1,87,29124,2808
14,123,29124,29247,-1,87,29247,11000
14,89,29247,29336,1,103,29247,2809
14,89,29247,29336,-1,103,29336,11001
14,126,29336,29462,1,122,29336,2810
14,126,29336,29462,-1,122,29462,11002
14,129,29462,29591,1,4,29462,2811
14,129,29462,29591,-1,4,29591,11003
14,152,29591,29743,1,181,29591,2812
14,152,29591,29743,-1,181,29743,11004
14,44,29743,29787,1,158,29743,2813
14,44,29743,29787,-1,158,29787,11005
14,132,29787,29919,1,254,29787,2814
14,132,29787,29919,-1,254,29919,11006
14,192,29919,30111,1,3,29919,2815
14,192,29919,30111,-1,3,30111,11007
14,193,30111,30304,1,65,30111,2816
14,193,30111,30304,-1,65,30304,11008
14,135,30304,30439,1,107,30304,2817
14,135,30304,30439,-1,107,30439,11009
14,103,30439,30542,1,23,30439,2818
14,103,30439,30542,-1,23,30542,11010
14,134,30542,30676,1,49,30542,2819
14,134,30542,30676,-1,49,30676,11011
14,104,30676,30780,1,113,30676,2820
14,104,30676,30780,-1,113,30780,11012
14,63,30780,30843,1,141,30780,2821
14,63,30780,30843,-1,141,30843,11013
14,231,30843,31074,1,208,30843,2822
14,231,30843,31074,-1,208,31074,11014
14,350,31074,31424,1,197,31074,2823
14,350,31074,31424,-1,197,31424,11015
14,131,31424,31555,1,61,31424,2824
14,131,31424,31555,-1,61,31555,11016
14,150,31555,31705,1,149,31555,2825
14,150,31555,31705,-1,149,31705,11017
14,83,31705,31788,1,69,31705,2826
14,83,31705,31788,-1,69,31788,11018
14,90,31788,31878,1,53,31788,2827
14,90,31788,31878,-1,53,31878,11019
14,125,31878,32003,1,199,31878,2828
14,125,31878,32003,-1,199,32003,11020
14,30,32003,32033,1,146,32003,2829
14,30,32003,32033,-1,146,32033,11021
14,106,32033,32139,1,91,32033,2830
14,106,32033,32139,-1,91,32139,11022
14,204,32139,32343,1,228,32139,2831
14,204,32139,32343,-1,228,32343,11023
14,85,32343,32428,1,14,32343,2832
14,85,32343,32428,-1,14,32428,11024
14,91,32428,32519,1,194,32428,2833
14,91,32428,32519,-1,194,32519,11025
14,180,32519,32699,1,254,32519,2834
14,180,32519,32699,-1,254,32699,11026
14,162,32699,32861,1,83,32699,2835
14,162,32699,32861,-1,83,32861,11027
14,107,32861,32968,1,6,32861,2836
14,107,32861,32968,-1,6,32968,11028
14,137,32968,33105,1,186,32968,2837
14,137,32968,33105,-1,186,33105,11029
14,173,33105,33278,1,197,33105,2838
14,173,33105,33278,-1,197,33278,11030
14,103,33278,33381,1,13,33278,2839
14,103,33278,33381,-1,13,33381,11031
14,157,33381,33538,1,9,33381,2840
14,157,33381,33538,-1,9,33538,11032
14,165,33538,33703,1,250,33538,2841
14,165,33538,33703,-1,250,33703,11033
14,40,33703,33743,1,247,33703,2842
14,40,33703,33743,-1,247,33743,11034
14,78,33743,33821,1,254,33743,2843
14,78,33743,33821,-1,254,33821,11035
14,216,33821,34037,1,138,33821,2844
14,216,33821,34037,-1,138,34037,11036
14,234,34037,34271,1,207,34037,2845
14,234,34037,34271,-1,207,34271,11037
14,57,34271,34328,1,138,34271,2846
14,57,34271,34328,-1,138,34328,11038
14,146,34328,34474,1,50,34328,2847
14,146,34328,34474,-1,50,34474,11039
14,102,34474,34576,1,223,34474,2848
14,102,34474,34576,-1,223,34576,11040
14,98,34576,34674,1,217,34576,2849
14,98,34576,34674,-1,217,34674,11041
14,109,34674,34783,1,67,34674,2850
14,109,34674,34783,-1,67,34783,11042
14,192,34783,34975,1,35,34783,2851
14,192,34783,34975,-1,35,34975,11043
14,160,34975,35135,1,164,34975,2852
14,160,34975,35135,-1,164,35135,11044
14,228,35135,35363,1,181,35135,2853
14,228,35135,35363,-1,181,35363,11045
14,242,35363,35605,1,229,35363,2854
14,242,35363,35605,-1,229,35605,11046
14,163,35605,35768,1,29,35605,2855
14,163,35605,35768,-1,29,35768,11047
14,90,35768,35858,1,165,35768,2856
14,90,35768,35858,-1,165,35858,11048
14,83,35858,35941,1,203,35858,2857
14,83,35858,35941,-1,203,35941,11049
14,175,35941,36116,1,186,35941,2858
14,175,35941,36116,-1,186,36116,11050
14,132,36116,36248,1,96,36116,2859
14,132,36116,36248,-1,96,36248,11051
14,59,36248,36307,1,1,36248,2860
14,59,36248,36307,-1,1,36307,11052
14,147,36307,36454,1,227,36307,2861
14,147,36307,36454,-1,227,36454,11053
14,83,36454,36537,1,118,36454,2862
14,83,36454,36537,-1,118,36537,11054
14,195,36537,36732,1,103,36537,2863
14,195,36537,36732,-1,103,36732,11055
14,106,36732,36838,1,43,36732,2864
14,106,36732,36838,-1,43,36838,11056
14,36,36838,36874,1,161,36838,2865
14,36,36838,36874,-1,161,36874,11057
14,186,36874,37060,1,145,36874,2866
14,186,36874,37060,-1,145,37060,11058
14,107,37060,37167,1,193,37060,2867
14,107,37060,37167,-1,193,37167,11059
15,233,0,233,1,54,0,1
15,233,0,233,-1,54,233,8193
15,52,233,285,1,186,233,2
15,52,233,285,-1,186,285,8194
15,59,285,344,1,47,285,3
15,59,285,344,-1,47,344,8195
15,88,344,432,1,129,344,4
15,88,344,432,-1,129,432,8196
15,106,432,538,1,225,432,5
15,106,432,538,-1,225,538,8197
15,94,538,632,1,138,538,6
15,94,538,632,-1,138,632,8198
15,75,632,707,1,80,632,7
15,75,632,707,-1,80,707,8199
15,122,707,829,1,218,707,8
15,122,707,829,-1,218,829,8200
15,113,829,942,1,88,829,9
15,113,829,942,-1,88,942,8201
15,112,942,1054,1,79,942,10
15,112,942,1054,-1,79,1054,8202
15,69,1054,1123,1,36,1054,11
15,69,1054,1123,-1,36,1123,8203
15,262,1123,1385,1,251,1123,12
15,262,1123,1385,-1,251,1385,8204
15,186,1385,1571,1,40,1385,13
15,186,1385,1571,-1,40,1571,8205
15,146,1571,1717,1,155,1571,14
15,146,1571,1717,-1,155,1717,8206
15,33,1717,1750,1,229,1717,15
15,33,1717,1750,-1,229,1750,8207
15,115,1750,1865,1,144,1750,16
15,115,1750,1865,-1,144,1865,8208
15,28,1865,1893,1,50,1865,17
15,28,1865,1893,-1,50,1893,8209
15,178,1893,2071,1,118,1893,18
15,178,1893,2071,-1,118,2071,8210
15,78,2071,2149,1,90,2071,19
15,78,2071,2149,-1,90,2149,8211
15,103,2149,2252,1,100,2149,20
15,103,2149,2252,-1,100,2252,8212
15,127,2252,2379,1,236,2252,21
15,127,2252,2379,-1,236,2379,8213
15,82,2379,2461,1,31,2379,22
15,82,2379,2461,-1,31,2461,8214
15,166,2461,2627,1,90,2461,23
15,166,2461,2627,-1,90,2627,8215
15,39,2627,2666,1,35,2627,24
15,39,2627,2666,-1,35,2666,8216
15,177,2666,2843,1,173,2666,25
15,177,2666,2843,-1,173,2843,8217
15,323,2843,3166,1,232,2843,26
15,323,2843,3166,-1,232,3166,8218
15,183,3166,3349,1,85,3166,27
15,183,3166,3349,-1,85,3349,8219
15,244,3349,3593,1,57,3349,28
15,244,3349,3593,-1,57,3593,8220
15,123,3593,3716,1,106,3593,29
15,123,3593,3716,-1,106,3716,8221
15,51,3716,3767,1,113,3716,30
15,51,3716,3767,-1,113,3767,8222
15,141,3767,3908,1,203,3767,31
15,141,3767,3908,-1,203,3908,8223
15,134,3908,4042,1,256,3908,32
15,134,3908,4042,-1,256,4042,8224
15,82,4042,4124,1,232,4042,33
15,82,4042,4124,-1,232,4124,8225
15,165,4124,4289,1,171,4124,34
15,165,4124,4289,-1,171,4289,8226
15,69,4289,4358,1,205,4289,35
15,69,4289,4358,-1,205,4358,8227
15,138,4358,4496,1,54,4358,36
15,138,4358,4496,-1,54,4496,8228
15,121,4496,4617,1,223,4496,37
15,121,4496,4617,-1,223,4617,8229
15,144,4617,4761,1,173,4617,38
15,144,4617,4761,-1,173,4761,8230
15,176,4761,4937,1,205,4761,39
15,176,4761,4937,-1,205,4937,8231
15,338,4937,5275,1,114,4937,40
15,338,4937,5275,-1,114,5275,8232
15,96,5275,5371,1,125,5275,41
15,96,5275,5371,-1,125,5371,8233
15,127,5371,5498,1,125,5371,42
15,127,5371,5498,-1,125,5498,8234
15,133,5498,5631,1,91,5498,43
15,133,5498,5631,-1,91,5631,8235
15,63,5631,5694,1,220,5631,44
15,63,5631,5694,-1,220,5694,8236
15,164,5694,5858,1,244,5694,45
15,164,5694,5858,-1,244,5858,8237
15,83,5858,5941,1,234,5858,46
15,83,5858,5941,-1,234,5941,8238
15,91,5941,6032,1,197,5941,47
15,91,5941,6032,-1,197,6032,8239
15,116,6032,6148,1,253,6032,48
15,116,6032,6148,-1,253,6148,8240
15,217,6148,6365,1,195,6148,49
15,217,6148,6365,-1,195,6365,8241
15,32,6365,6397,1,93,6365,50
15,32,6365,6397,-1,93,6397,8242
15,161,6397,6558,1,148,6397,51
15,161,6397,6558,-1,148,6558,8243
15,57,6558,6615,1,174,6558,52
15,57,6558,6615,-1,174,6615,8244
15,229,6615,6844,1,10,6615,53
15,229,6615,6844,-1,10,6844,8245
15,92,6844,6936,1,29,6844,54
15,92,6844,6936,-1,29,6936,8246
15,148,6936,7084,1,165,6936,55
15,148,6936,7084,-1,165,7084,8247
15,132,7084,7216,1,130,7084,56
15,132,7084,7216,-1,130,7216,8248
15,149,7216,7365,1,68,7216,57
15,149,7216,7365,-1,68,7365,8249
15,179,7365,7544,1,38,7365,58
15,179,7365,7544,-1,38,7544,8250
15,29,7544,7573,1,145,7544,59
15,29,7544,7573,-1,145,7573,8251
15,66,7573,7639,1,74,7573,60
15,66,7573,7639,-1,74,7639,8252
15,62,7639,7701,1,41,7639,61
15,62,7639,7701,-1,41,7701,8253
15,150,7701,7851,1,222,7701,62
15,150,7701,7851,-1,222,7851,8254
15,114,7851,7965,1,142,7851,63
15,114,7851,7965,-1,142,7965,8255
15,66,7965,8031,1,13,7965,64
15,66,7965,8031,-1,13,8031,8256
15,82,8031,8113,1,211,8031,65
15,82,8031,8113,-1,211,8113,8257
15,38,8113,8151,1,151,8113,66
15,38,8113,8151,-1,151,8151,8258
15,247,8151,8398,1,57,8151,67
15,247,8151,8398,-1,57,8398,8259
15,145,8398,8543,1,205,8398,68
15,145,8398,8543,-1,205,8543,8260
15,65,8543,8608,1,113,8543,69
15,65,8543,8608,-1,113,8608,8261
15,248,8608,8856,1,128,8608,70
15,248,8608,8856,-1,128,8856,8262
15,112,8856,8968,1,162,8856,71
15,112,8856,8968,-1,162,8968,8263
15,149,8968,9117,1,229,8968,72
15,149,8968,9117,-1,229,9117,8264
15,155,9117,9272,1,74,9117,73
15,155,9117,9272,-1,74,9272,8265
15,233,9272,9505,1,25,9272,74
15,233,9272,9505,-1,25,9505,8266
15,314,9505,9819,1,236,9505,75
15,314,9505,9819,-1,236,9819,8267
15,317,9819,10136,1,45,9819,76
15,317,9819,10136,-1,45,10136,8268
15,112,10136,10248,1,97,10136,77
15,112,10136,10248,-1,97,10248,8269
15,67,10248,10315,1,129,10248,78
15,67,10248,10315,-1,129,10315,8270
15,178,10315,10493,1,238,10315,79
15,178,10315,10493,-1,238,10493,8271
15,129,10493,10622,1,3,10493,80
15,129,10493,10622,-1,3,10622,8272
15,113,10622,10735,1,192,10622,81
15,113,10622,10735,-1,192,10735,8273
15,112,10735,10847,1,48,10735,82
15,112,10735,10847,-1,48,10847,8274
15,133,10847,10980,1,6,10847,83
15,133,10847,10980,-1,6,10980,8275
15,78,10980,11058,1,209,10980,84
15,78,10980,11058,-1,209,11058,8276
15,65,11058,11123,1,88,11058,85
15,65,11058,11123,-1,88,11123,8277
15,138,11123,11261,1,222,11123,86
15,138,11123,11261,-1,222,11261,8278
15,123,11261,11384,1,248,11261,87
15,123,11261,11384,-1,248,11384,8279
15,287,11384,11671,1,215,11384,88
15,287,11384,11671,-1,215,11671,8280
15,53,11671,11724,1,84,11671,89
15,53,11671,11724,-1,84,11724,8281
15,229,11724,11953,1,110,11724,90
15,229,11724,11953,-1,110,11953,8282
15,136,11953,12089,1,228,11953,91
15,136,11953,12089,-1,228,12089,8283
15,180,12089,12269,1,9,12089,92
15,180,12089,12269,-1,9,12269,8284
15,59,12269,12328,1,135,12269,93
15,59,12269,12328,-1,135,12328,8285
15,44,12328,12372,1,144,12328,94
15,44,12328,12372,-1,144,12372,8286
15,78,12372,12450,1,187,12372,95
15,78,12372,12450,-1,187,12450,8287
15,59,12450,12509,1,249,12450,96
15,59,12450,12509,-1,249,12509,8288
15,227,12509,12736,1,58,12509,97
15,227,12509,12736,-1,58,12736,8289
15,227,12736,12963,1,97,12736,98
15,227,12736,12963,-1,97,12963,8290
15,73,12963,13036,1,217,12963,99
15,73,12963,13036,-1,217,13036,8291
15,334,13036,13370,1,102,13036,100
15,334,13036,13370,-1,102,13370,8292
15,81,13370,13451,1,42,13370,101
15,81,13370,13451,-1,42,13451,8293
15,93,13451,13544,1,106,13451,102
15,93,13451,13544,-1,106,13544,8294
15,100,13544,13644,1,44,13544,103
15,100,13544,13644,-1,44,13644,8295
15,156,13644,13800,1,217,13644,104
15,156,13644,13800,-1,217,13800,8296
15,74,13800,13874,1,27,13800,105
15,74,13800,13874,-1,27,13874,8297
15,102,13874,13976,1,235,13874,106
15,102,13874,13976,-1,235,13976,8298
15,91,13976,14067,1,68,13976,107
15,91,13976,14067,-1,68,14067,8299
15,122,14067,14189,1,48,14067,108
15,122,14067,14189,-1,48,14189,8300
15,177,14189,14366,1,199,14189,109
15,177,14189,14366,-1,199,14366,8301
15,74,14366,14440,1,136,14366,110
15,74,14366,14440,-1,136,14440,8302
15,72,14440,14512,1,135,14440,111
15,72,14440,14512,-1,135,14512,8303
15,223,14512,14735,1,15,14512,112
15,223,14512,14735,-1,15,14735,8304
15,116,14735,14851,1,233,14735,113
15,116,14735,14851,-1,233,14851,8305
15,18,14851,14869,1,121,14851,114
15,18,14851,14869,-1,121,14869,8306
15,70,14869,14939,1,127,14869,115
15,70,14869,14939,-1,127,14939,8307
15,143,14939,15082,1,48,14939,116
15,143,14939,15082,-1,48,15082,8308
15,54,15082,15136,1,136,15082,117
15,54,15082,15136,-1,136,15136,8309
15,76,15136,15212,1,230,15136,118
15,76,15136,15212,-1,230,15212,8310
15,310,15212,15522,1,84,15212,119
15,310,15212,15522,-1,84,15522,8311
15,102,15522,15624,1,222,15522,120
15,102,15522,15624,-1,222,15624,8312
15,57,15624,15681,1,63,15624,121
15,57,15624,15681,-1,63,15681,8313
15,114,15681,15795,1,40,15681,122
15,114,15681,15795,-1,40,15795,8314
15,68,15795,15863,1,14,15795,123
15,68,15795,15863,-1,14,15863,8315
15,139,15863,16002,1,214,15863,124
15,139,15863,16002,-1,214,16002,8316
15,188,16002,16190,1,111,16002,125
15,188,16002,16190,-1,111,16190,8317
15,162,16190,16352,1,193,16190,126
15,162,16190,16352,-1,193,16352,8318
15,101,16352,16453,1,216,16352,127
15,101,16352,16453,-1,216,16453,8319
15,134,16453,16587,1,113,16453,128
15,134,16453,16587,-1,113,16587,8320
15,127,16587,16714,1,66,16587,129
15,127,16587,16714,-1,66,16714,8321
15,101,16714,16815,1,236,16714,130
15,101,16714,16815,-1,236,16815,8322
15,152,16815,16967,1,7,16815,131
15,152,16815,16967,-1,7,16967,8323
15,118,16967,17085,1,129,16967,132
15,118,16967,17085,-1,129,17085,8324
15,121,17085,17206,1,132,17085,133
15,121,17085,17206,-1,132,17206,8325
15,196,17206,17402,1,248,17206,134
15,196,17206,17402,-1,248,17402,8326
15,87,17402,17489,1,113,17402,135
15,87,17402,17489,-1,113,17489,8327
15,104,17489,17593,1,181,17489,136
15,104,17489,17593,-1,181,17593,8328
15,221,17593,17814,1,246,17593,137
15,221,17593,17814,-1,246,17814,8329
15,67,17814,17881,1,190,17814,138
15,67,17814,17881,-1,190,17881,8330
15,87,17881,17968,1,196,17881,139
15,87,17881,17968,-1,196,17968,8331
15,76,17968,18044,1,93,17968,140
15,76,17968,18044,-1,93,18044,8332
15,170,18044,18214,1,93,18044,141
15,170,18044,18214,-1,93,18214,8333
15,92,18214,18306,1,239,18214,142
15,92,18214,18306,-1,239,18306,8334
15,145,18306,18451,1,20,18306,143
15,145,18306,18451,-1,20,18451,8335
15,104,18451,18555,1,40,18451,144
15,104,18451,18555,-1,40,18555,8336
15,106,18555,18661,1,230,18555,145
15,106,18555,18661,-1,230,18661,8337
15,244,18661,18905,1,95,18661,146
15,244,18661,18905,-1,95,18905,8338
15,136,18905,19041,1,201,18905,147
15,136,18905,19041,-1,201,19041,8339
15,202,19041,19243,1,131,19041,148
15,202,19041,19243,-1,131,19243,8340
15,119,19243,19362,1,231,19243,149
15,119,19243,19362,-1,231,19362,8341
15,99,19362,19461,1,43,19362,150
15,99,19362,19461,-1,43,19461,8342
15,138,19461,19599,1,148,19461,151
15,138,19461,19599,-1,148,19599,8343
15,170,19599,19769,1,160,19599,152
15,170,19599,19769,-1,160,19769,8344
15,269,19769,20038,1,177,19769,153
15,269,19769,20038,-1,177,20038,8345
15,54,20038,20092,1,26,20038,154
15,54,20038,20092,-1,26,20092,8346
15,76,20092,20168,1,15,20092,155
15,76,20092,20168,-1,15,20168,8347
15,128,20168,20296,1,39,20168,156
15,128,20168,20296,-1,39,20296,8348
15,216,20296,20512,1,139,20296,157
15,216,20296,20512,-1,139,20512,8349
15,48,20512,20560,1,113,20512,158
15,48,20512,20560,-1,113,20560,8350
15,190,20560,20750,1,226,20560,159
15,190,20560,20750,-1,226,20750,8351
15,130,20750,20880,1,119,20750,160
15,130,20750,20880,-1,119,20880,8352
15,61,20880,20941,1,234,20880,161
15,61,20880,20941,-1,234,20941,8353
15,204,20941,21145,1,144,20941,162
15,204,20941,21145,-1,144,21145,8354
15,220,21145,21365,1,63,21145,163
15,220,21145,21365,-1,63,21365,8355
15,123,21365,21488,1,197,21365,164
15,123,21365,21488,-1,197,21488,8356
15,77,21488,21565,1,118,21488,165
15,77,21488,21565,-1,118,21565,8357
15,53,21565,21618,1,223,21565,166
15,53,21565,21618,-1,223,21618,8358
15,244,21618,21862,1,64,21618,167
15,244,21618,21862,-1,64,21862,8359
15,74,21862,21936,1,78,21862,168
15,74,21862,21936,-1,78,21936,8360
15,101,21936,22037,1,177,21936,169
15,101,21936,22037,-1,177,22037,8361
15,193,22037,22230,1,79,22037,170
15,193,22037,22230,-1,79,22230,8362
15,71,22230,22301,1,230,22230,171
15,71,22230,22301,-1,230,22301,8363
15,87,22301,22388,1,242,22301,172
15,87,22301,22388,-1,242,22388,8364
15,81,22388,22469,1,152,22388,173
15,81,22388,22469,-1,152,22469,8365
15,207,22469,22676,1,249,22469,174
15,207,22469,22676,-1,249,22676,8366
15,51,22676,22727,1,148,22676,175
15,51,22676,22727,-1,148,22727,8367
15,111,22727,22838,1,60,22727,176
15,111,22727,22838,-1,60,22838,8368
15,158,22838,22996,1,202,22838,177
15,158,22838,22996,-1,202,22996,8369
15,162,22996,23158,1,167,22996,178
15,162,22996,23158,-1,167,23158,8370
15,89,23158,23247,1,223,23158,179
15,89,23158,23247,-1,223,23247,8371
15,115,23247,23362,1,107,23247,180
15,115,23247,23362,-1,107,23362,8372
15,122,23362,23484,1,94,23362,181
15,122,23362,23484,-1,94,23484,8373
15,128,23484,23612,1,27,23484,182
15,128,23484,23612,-1,27,23612,8374
15,147,23612,23759,1,113,23612,183
15,147,23612,23759,-1,113,23759,8375
15,120,23759,23879,1,12,23759,184
15,120,23759,23879,-1,12,23879,8376
15,94,23879,23973,1,56,23879,185
15,94,23879,23973,-1,56,23973,8377
15,88,23973,24061,1,23,23973,186
15,88,23973,24061,-1,23,24061,8378
15,148,24061,24209,1,16,24061,187
15,148,24061,24209,-1,16,24209,8379
15,88,24209,24297,1,70,24209,188
15,88,24209,24297,-1,70,24297,8380
15,73,24297,24370,1,118,24297,189
15,73,24297,24370,-1,118,24370,8381
15,231,24370,24601,1,245,24370,190
15,231,24370,24601,-1,245,24601,8382
15,131,24601,24732,1,154,24601,191
15,131,24601,24732,-1,154,24732,8383
15,182,24732,24914,1,12,24732,192
15,182,24732,24914,-1,12,24914,8384
15,72,24914,24986,1,211,24914,193
15,72,24914,24986,-1,211,24986,8385
15,137,24986,25123,1,34,24986,194
15,137,24986,25123,-1,34,25123,8386
15,120,25123,25243,1,10,25123,195
15,120,25123,25243,-1,10,25243,8387
15,59,25243,25302,1,201,25243,196
15,59,25243,25302,-1,201,25302,8388
15,117,25302,25419,1,45,25302,197
15,117,25302,25419,-1,45,25419,8389
15,47,25419,25466,1,138,25419,198
15,47,25419,25466,-1,138,25466,8390
15,166,25466,25632,1,44,25466,199
15,166,25466,25632,-1,44,25632,8391
15,52,25632,25684,1,53,25632,200
15,52,25632,25684,-1,53,25684,8392
15,43,25684,25727,1,12,25684,201
15,43,25684,25727,-1,12,25727,8393
15,231,25727,25958,1,110,25727,202
15,231,25727,25958,-1,110,25958,8394
15,47,25958,26005,1,179,25958,203
15,47,25958,26005,-1,179,26005,8395
15,187,26005,26192,1,220,26005,204
15,187,26005,26192,-1,220,26192,8396
15,145,26192,26337,1,4,26192,205
15,145,26192,26337,-1,4,26337,8397
15,107,26337,26444,1,22,26337,206
15,107,26337,26444,-1,22,26444,8398
15,194,26444,26638,1,205,26444,207
15,194,26444,26638,-1,205,26638,8399
15,302,26638,26940,1,61,26638,208
15,302,26638,26940,-1,61,26940,8400
15,168,26940,27108,1,251,26940,209
15,168,26940,27108,-1,251,27108,8401
15,111,27108,27219,1,236,27108,210
15,111,27108,27219,-1,236,27219,8402
15,117,27219,27336,1,228,27219,211
15,117,27219,27336,-1,228,27336,8403
15,131,27336,27467,1,36,27336,212
15,131,27336,27467,-1,36,27467,8404
15,69,27467,27536,1,155,27467,213
15,69,27467,27536,-1,155,27536,8405
15,225,27536,27761,1,226,27536,214
15,225,27536,27761,-1,226,27761,8406
15,193,27761,27954,1,106,27761,215
15,193,27761,27954,-1,106,27954,8407
15,172,27954,28126,1,159,27954,216
15,172,27954,28126,-1,159,28126,8408
15,138,28126,28264,1,235,28126,217
15,138,28126,28264,-1,235,28264,8409
15,173,28264,28437,1,120,28264,218
15,173,28264,28437,-1,120,28437,8410
15,95,28437,28532,1,161,28437,219
15,95,28437,28532,-1,161,28532,8411
15,127,28532,28659,1,48,28532,220
15,127,28532,28659,-1,48,28659,8412
15,107,28659,28766,1,201,28659,221
15,107,28659,28766,-1,201,28766,8413
15,27,28766,28793,1,252,28766,222
15,27,28766,28793,-1,252,28793,8414
15,77,28793,28870,1,121,28793,223
15,77,28793,28870,-1,121,28870,8415
15,217,28870,29087,1,223,28870,224
15,217,28870,29087,-1,223,29087,8416
15,110,29087,29197,1,244,29087,225
15,110,29087,29197,-1,244,29197,8417
15,120,29197,29317,1,115,29197,226
15,120,29197,29317,-1,115,29317,8418
15,61,29317,29378,1,26,29317,227
15,61,29317,29378,-1,26,29378,8419
15,165,29378,29543,1,238,29378,228
15,165,29378,29543,-1,238,29543,8420
15,101,29543,29644,1,70,29543,229
15,101,29543,29644,-1,70,29644,8421
15,147,29644,29791,1,148,29644,230
15,147,29644,29791,-1,148,29791,8422
15,172,29791,29963,1,175,29791,231
15,172,29791,29963,-1,175,29963,8423
15,150,29963,30113,1,165,29963,232
15,150,29963,30113,-1,165,30113,8424
15,54,30113,30167,1,85,30113,233
15,54,30113,30167,-1,85,30167,8425
15,92,30167,30259,1,148,30167,234
15,92,30167,30259,-1,148,30259,8426
15,103,30259,30362,1,230,30259,235
15,103,30259,30362,-1,230,30362,8427
15,234,30362,30596,1,108,30362,236
15,234,30362,30596,-1,108,30596,8428
15,173,30596,30769,1,113,30596,237
15,173,30596,30769,-1,113,30769,8429
15,135,30769,30904,1,191,30769,238
15,135,30769,30904,-1,191,30904,8430
15,116,30904,31020,1,22,30904,239
15,116,30904,31020,-1,22,31020,8431
15,64,31020,31084,1,183,31020,240
15,64,31020,31084,-1,183,31084,8432
15,75,31084,31159,1,252,31084,241
15,75,31084,31159,-1,252,31159,8433
15,148,31159,31307,1,123,31159,242
15,148,31159,31307,-1,123,31307,8434
15,145,31307,31452,1,61,31307,243
15,145,31307,31452,-1,61,31452,8435
15,85,31452,31537,1,11,31452,244
15,85,31452,31537,-1,11,31537,8436
15,103,31537,31640,1,166,31537,245
15,103,31537,31640,-1,166,31640,8437
15,207,31640,31847,1,110,31640,246
15,207,31640,31847,-1,110,31847,8438
15,149,31847,31996,1,129,31847,247
15,149,31847,31996,-1,129,31996,8439
15,224,31996,32220,1,76,31996,248
15,224,31996,32220,-1,76,32220,8440
15,83,32220,32303,1,131,32220,249
15,83,32220,32303,-1,131,32303,8441
15,124,32303,32427,1,9,32303,250
15,124,32303,32427,-1,9,32427,8442
15,214,32427,32641,1,230,32427,251
15,214,32427,32641,-1,230,32641,8443
15,169,32641,32810,1,252,32641,252
15,169,32641,32810,-1,252,32810,8444
15,216,32810,33026,1,54,32810,253
15,216,32810,33026,-1,54,33026,8445
15,177,33026,33203,1,164,33026,254
15,177,33026,33203,-1,164,33203,8446
15,309,33203,33512,1,230,33203,255
15,309,33203,33512,-1,230,33512,8447
15,123,33512,33635,1,77,33512,256
15,123,33512,33635,-1,77,33635,8448
15,185,33635,33820,1,157,33635,257
15,185,33635,33820,-1,157,33820,8449
15,119,33820,33939,1,89,33820,258
15,119,33820,33939,-1,89,33939,8450
15,243,33939,34182,1,225,33939,259
15,243,33939,34182,-1,225,34182,8451
15,123,34182,34305,1,188,34182,260
15,123,34182,34305,-1,188,34305,8452
15,123,34305,34428,1,254,34305,261
15,123,34305,34428,-1,254,34428,8453
15,146,34428,34574,1,33,34428,262
15,146,34428,34574,-1,33,34574,8454
15,56,34574,34630,1,206,34574,263
15,56,34574,34630,-1,206,34630,8455
15,59,34630,34689,1,216,34630,264
15,59,34630,34689,-1,216,34689,8456
15,243,34689,34932,1,10,34689,265
15,243,34689,34932,-1,10,34932,8457
15,104,34932,35036,1,143,34932,266
15,104,34932,35036,-1,143,35036,8458
15,270,35036,35306,1,42,35036,267
15,270,35036,35306,-1,42,35306,8459
15,316,35306,35622,1,103,35306,268
15,316,35306,35622,-1,103,35622,8460
15,96,35622,35718,1,115,35622,269
15,96,35622,35718,-1,115,35718,8461
16,78,0,78,1,194,0,5942
16,78,0,78,-1,194,78,14134
16,32,78,110,1,121,78,5943
16,32,78,110,-1,121,110,14135
16,118,110,228,1,84,110,5944
16,118,110,228,-1,84,228,14136
16,79,228,307,1,95,228,5945
16,79,228,307,-1,95,307,14137
16,146,307,453,1,247,307,5946
16,146,307,453,-1,247,453,14138
16,112,453,565,1,153,453,5947
16,112,453,565,-1,153,565,14139
16,175,565,740,1,62,565,5948
16,175,565,740,-1,62,740,14140
16,88,740,828,1,104,740,5949
16,88,740,828,-1,104,828,14141
16,132,828,960,1,99,828,5950
16,132,828,960,-1,99,960,14142
16,60,960,1020,1,99,960,5951
16,60,960,1020,-1,99,1020,14143
16,75,1020,1095,1,251,1020,5952
16,75,1020,1095,-1,251,1095,14144
16,245,1095,1340,1,175,1095,5953
16,245,1095,1340,-1,175,1340,14145
16,100,1340,1440,1,219,1340,5954
16,100,1340,1440,-1,219,1440,14146
16,69,1440,1509,1,92,1440,5955
16,69,1440,1509,-1,92,1509,14147
16,125,1509,1634,1,168,1509,5956
16,125,1509,1634,-1,168,1634,14148
16,138,1634,1772,1,221,1634,5957
16,138,1634,1772,-1,221,1772,14149
16,167,1772,1939,1,83,1772,5958
16,167,1772,1939,-1,83,1939,14150
16,200,1939,2139,1,152,1939,5959
16,200,1939,2139,-1,152,2139,14151
16,185,2139,2324,1,142,2139,5960
16,185,2139,2324,-1,142,2324,14152
16,425,2324,2749,1,22,2324,5961
16,425,2324,2749,-1,22,2749,14153
16,153,2749,2902,1,169,2749,5962
16,153,2749,2902,-1,169,2902,14154
16,110,2902,3012,1,147,2902,5963
16,110,2902,3012,-1,147,3012,14155
16,120,3012,3132,1,242,3012,5964
16,120,3012,3132,-1,242,3132,14156
16,123,3132,3255,1,217,3132,5965
16,123,3132,3255,-1,217,3255,14157
16,159,3255,3414,1,248,3255,5966
16,159,3255,3414,-1,248,3414,14158
16,170,3414,3584,1,72,3414,5967
16,170,3414,3584,-1,72,3584,14159
16,174,3584,3758,1,152,3584,5968
16,174,3584,3758,-1,152,3758,14160
16,35,3758,3793,1,221,3758,5969
16,35,3758,3793,-1,221,3793,14161
16,45,3793,3838,1,202,3793,5970
16,45,3793,3838,-1,202,3838,14162
16,162,3838,4000,1,154,3838,5971
16,162,3838,4000,-1,154,4000,14163
16,137,4000,4137,1,78,4000,5972
16,137,4000,4137,-1,78,4137,14164
16,98,4137,4235,1,116,4137,5973
16,98,4137,4235,-1,116,4235,14165
16,59,4235,4294,1,93,4235,5974
16,59,4235,4294,-1,93,4294,14166
16,151,4294,4445,1,185,4294,5975
16,151,4294,4445,-1,185,4445,14167
16,27,4445,4472,1,103,4445,5976
16,27,4445,4472,-1,103,4472,14168
16,37,4472,4509,1,249,4472,5977
16,37,4472,4509,-1,249,4509,14169
16,141,4509,4650,1,192,4509,5978
16,141,4509,4650,-1,192,4650,14170
16,105,4650,4755,1,215,4650,5979
16,105,4650,4755,-1,215,4755,14171
16,82,4755,4837,1,212,4755,5980
16,82,4755,4837,-1,212,4837,14172
16,186,4837,5023,1,158,4837,5981
16,186,4837,5023,-1,158,5023,14173
16,64,5023,5087,1,206,5023,5982
16,64,5023,5087,-1,206,5087,14174
16,138,5087,5225,1,22,5087,5983
16,138,5087,5225,-1,22,5225,14175
16,91,5225,5316,1,256,5225,5984
16,91,5225,5316,-1,256,5316,14176
16,84,5316,5400,1,82,5316,5985
16,84,5316,5400,-1,82,5400,14177
16,102,5400,5502,1,237,5400,5986
16,102,5400,5502,-1,237,5502,14178
16,98,5502,5600,1,236,5502,5987
16,98,5502,5600,-1,236,5600,14179
16,59,5600,5659,1,6,5600,5988
16,59,5600,5659,-1,6,5659,14180
16,103,5659,5762,1,168,5659,5989
16,103,5659,5762,-1,168,5762,14181
16,168,5762,5930,1,94,5762,5990
16,168,5762,5930,-1,94,5930,14182
16,35,5930,5965,1,51,5930,5991
16,35,5930,5965,-1,51,5965,14183
16,161,5965,6126,1,145,5965,5992
16,161,5965,6126,-1,145,6126,14184
16,106,6126,6232,1,16,6126,5993
16,106,6126,6232,-1,16,6232,14185
16,102,6232,6334,1,191,6232,5994
16,102,6232,6334,-1,191,6334,14186
16,109,6334,6443,1,49,6334,5995
16,109,6334,6443,-1,49,6443,14187
16,141,6443,6584,1,133,6443,5996
16,141,6443,6584,-1,133,6584,14188
16,68,6584,6652,1,187,6584,5997
16,68,6584,6652,-1,187,6652,14189
16,108,6652,6760,1,34,6652,5998
16,108,6652,6760,-1,34,6760,14190
16,160,6760,6920,1,86,6760,5999
16,160,6760,6920,-1,86,6920,14191
16,91,6920,7011,1,1,6920,6000
16,91,6920,7011,-1,1,7011,14192
16,76,7011,7087,1,145,7011,6001
16,76,7011,7087,-1,145,7087,14193
16,84,7087,7171,1,100,7087,6002
16,84,7087,7171,-1,100,7171,14194
16,124,7171,7295,1,59,7171,6003
16,124,7171,7295,-1,59,7295,14195
16,149,7295,7444,1,82,7295,6004
16,149,7295,7444,-1,82,7444,14196
16,160,7444,7604,1,216,7444,6005
16,160,7444,7604,-1,216,7604,14197
16,163,7604,7767,1,151,7604,6006
16,163,7604,7767,-1,151,7767,14198
16,179,7767,7946,1,159,7767,6007
16,179,7767,7946,-1,159,7946,14199
16,227,7946,8173,1,77,7946,6008
16,227,7946,8173,-1,77,8173,14200
16,138,8173,8311,1,116,8173,6009
16,138,8173,8311,-1,116,8311,14201
16,62,8311,8373,1,54,8311,6010
16,62,8311,8373,-1,54,8373,14202
16,185,8373,8558,1,208,8373,6011
16,185,8373,8558,-1,208,8558,14203
16,108,8558,8666,1,51,8558,6012
16,108,8558,8666,-1,51,8666,14204
16,194,8666,8860,1,16,8666,6013
16,194,8666,8860,-1,16,8860,14205
16,99,8860,8959,1,54,8860,6014
16,99,8860,8959,-1,54,8959,14206
16,51,8959,9010,1,38,8959,6015
16,51,8959,9010,-1,38,9010,14207
16,102,9010,9112,1,166,9010,6016
16,102,9010,9112,-1,166,9112,14208
16,102,9112,9214,1,51,9112,6017
16,102,9112,9214,-1,51,9214,14209
16,135,9214,9349,1,106,9214,6018
16,135,9214,9349,-1,106,9349,14210
16,40,9349,9389,1,125,9349,6019
16,40,9349,9389,-1,125,9389,14211
16,146,9389,9535,1,180,9389,6020
16,146,9389,9535,-1,180,9535,14212
16,234,9535,9769,1,227,9535,6021
16,234,9535,9769,-1,227,9769,14213
16,85,9769,9854,1,214,9769,6022
16,85,9769,9854,-1,214,9854,14214
16,78,9854,9932,1,14,9854,6023
16,78,9854,9932,-1,14,9932,14215
16,38,9932,9970,1,166,9932,6024
16,38,9932,9970,-1,166,9970,14216
16,25,9970,9995,1,103,9970,6025
16,25,9970,9995,-1,103,9995,14217
16,119,9995,10114,1,241,9995,6026
16,119,9995,10114,-1,241,10114,14218
16,150,10114,10264,1,114,10114,6027
16,150,10114,10264,-1,114,10264,14219
16,228,10264,10492,1,141,10264,6028
16,228,10264,10492,-1,141,10492,14220
16,63,10492,10555,1,94,10492,6029
16,63,10492,10555,-1,94,10555,14221
16,13,10555,10568,1,199,10555,6030
16,13,10555,10568,-1,199,10568,14222
16,73,10568,10641,1,220,10568,6031
16,73,10568,10641,-1,220,10641,14223
16,74,10641,10715,1,127,10641,6032
16,74,10641,10715,-1,127,10715,14224
16,101,10715,10816,1,58,10715,6033
16,101,10715,10816,-1,58,10816,14225
16,74,10816,10890,1,45,10816,6034
16,74,10816,10890,-1,45,10890,14226
16,59,10890,10949,1,242,10890,6035
16,59,10890,10949,-1,242,10949,14227
16,117,10949,11066,1,123,10949,6036
16,117,10949,11066,-1,123,11066,14228
16,54,11066,11120,1,255,11066,6037
16,54,11066,11120,-1,255,11120,14229
16,151,11120,11271,1,173,11120,6038
16,151,11120,11271,-1,173,11271,14230
16,99,11271,11370,1,199,11271,6039
16,99,11271,11370,-1,199,11370,14231
16,137,11370,11507,1,37,11370,6040
16,137,11370,11507,-1,37,11507,14232
16,152,11507,11659,1,119,11507,6041
16,152,11507,11659,-1,119,11659,14233
16,96,11659,11755,1,134,11659,6042
16,96,11659,11755,-1,134,11755,14234
16,37,11755,11792,1,240,11755,6043
16,37,11755,11792,-1,240,11792,14235
16,150,11792,11942,1,110,11792,6044
16,150,11792,11942,-1,110,11942,14236
16,89,11942,12031,1,5,11942,6045
16,89,11942,12031,-1,5,12031,14237
16,97,12031,12128,1,100,12031,6046
16,97,12031,12128,-1,100,12128,14238
16,73,12128,12201,1,24,12128,6047
16,73,12128,12201,-1,24,12201,14239
16,116,12201,12317,1,240,12201,6048
16,116,12201,12317,-1,240,12317,14240
16,115,12317,12432,1,168,12317,6049
16,115,12317,12432,-1,168,12432,14241
16,89,12432,12521,1,15,12432,6050
16,89,12432,12521,-1,15,12521,14242
16,142,12521,12663,1,54,12521,6051
16,142,12521,12663,-1,54,12663,14243
16,40,12663,12703,1,214,12663,6052
16,40,12663,12703,-1,214,12703,14244
16,163,12703,12866,1,158,12703,6053
16,163,12703,12866,-1,158,12866,14245
16,190,12866,13056,1,145,12866,6054
16,190,12866,13056,-1,145,13056,14246
16,231,13056,13287,1,252,13056,6055
16,231,13056,13287,-1,252,13287,14247
16,148,13287,13435,1,124,13287,6056
16,148,13287,13435,-1,124,13435,14248
16,86,13435,13521,1,204,13435,6057
16,86,13435,13521,-1,204,13521,14249
16,173,13521,13694,1,161,13521,6058
16,173,13521,13694,-1,161,13694,14250
16,162,13694,13856,1,123,13694,6059
16,162,13694,13856,-1,123,13856,14251
16,165,13856,14021,1,201,13856,6060
16,165,13856,14021,-1,201,14021,14252
16,108,14021,14129,1,93,14021,6061
16,108,14021,14129,-1,93,14129,14253
16,206,14129,14335,1,123,14129,6062
16,206,14129,14335,-1,123,14335,14254
16,318,14335,14653,1,86,14335,6063
16,318,14335,14653,-1,86,14653,14255
16,115,14653,14768,1,30,14653,6064
16,115,14653,14768,-1,30,14768,14256
16,81,14768,14849,1,200,14768,6065
16,81,14768,14849,-1,200,14849,14257
16,189,14849,15038,1,37,14849,6066
16,189,14849,15038,-1,37,15038,14258
16,116,15038,15154,1,142,15038,6067
16,116,15038,15154,-1,142,15154,14259
16,36,15154,15190,1,189,15154,6068
16,36,15154,15190,-1,189,15190,14260
16,161,15190,15351,1,200,15190,6069
16,161,15190,15351,-1,200,15351,14261
16,166,15351,15517,1,72,15351,6070
16,166,15351,15517,-1,72,15517,14262
16,194,15517,15711,1,177,15517,6071
16,194,15517,15711,-1,177,15711,14263
16,123,15711,15834,1,15,15711,6072
16,123,15711,15834,-1,15,15834,14264
16,192,15834,16026,1,107,15834,6073
16,192,15834,16026,-1,107,16026,14265
16,83,16026,16109,1,96,16026,6074
16,83,16026,16109,-1,96,16109,14266
16,129,16109,16238,1,221,16109,6075
16,129,16109,16238,-1,221,16238,14267
16,94,16238,16332,1,242,16238,6076
16,94,16238,16332,-1,242,16332,14268
16,186,16332,16518,1,232,16332,6077
16,186,16332,16518,-1,232,16518,14269
16,167,16518,16685,1,55,16518,6078
16,167,16518,16685,-1,55,16685,14270
16,203,16685,16888,1,247,16685,6079
16,203,16685,16888,-1,247,16888,14271
16,72,16888,16960,1,74,16888,6080
16,72,16888,16960,-1,74,16960,14272
16,204,16960,17164,1,85,16960,6081
16,204,16960,17164,-1,85,17164,14273
16,73,17164,17237,1,96,17164,6082
16,73,17164,17237,-1,96,17237,14274
16,174,17237,17411,1,137,17237,6083
16,174,17237,17411,-1,137,17411,14275
16,126,17411,17537,1,62,17411,6084
16,126,17411,17537,-1,62,17537,14276
16,234,17537,17771,1,67,17537,6085
16,234,17537,17771,-1,67,17771,14277
16,102,17771,17873,1,33,17771,6086
16,102,17771,17873,-1,33,17873,14278
16,362,17873,18235,1,40,17873,6087
16,362,17873,18235,-1,40,18235,14279
16,157,18235,18392,1,5,18235,6088
16,157,18235,18392,-1,5,18392,14280
16,120,18392,18512,1,186,18392,6089
16,120,18392,18512,-1,186,18512,14281
16,119,18512,18631,1,48,18512,6090
16,119,18512,18631,-1,48,18631,14282
16,61,18631,18692,1,88,18631,6091
16,61,18631,18692,-1,88,18692,14283
16,144,18692,18836,1,114,18692,6092
16,144,18692,18836,-1,114,18836,14284
16,95,18836,18931,1,100,18836,6093
16,95,18836,18931,-1,100,18931,14285
16,87,18931,19018,1,148,18931,6094
16,87,18931,19018,-1,148,19018,14286
16,95,19018,19113,1,73,19018,6095
16,95,19018,19113,-1,73,19113,14287
16,230,19113,19343,1,61,19113,6096
16,230,19113,19343,-1,61,19343,14288
16,86,19343,19429,1,234,19343,6097
16,86,19343,19429,-1,234,19429,14289
16,57,19429,19486,1,3,19429,6098
16,57,19429,19486,-1,3,19486,14290
16,75,19486,19561,1,32,19486,6099
16,75,19486,19561,-1,32,19561,14291
16,111,19561,19672,1,151,19561,6100
16,111,19561,19672,-1,151,19672,14292
16,191,19672,19863,1,152,19672,6101
16,191,19672,19863,-1,152,19863,14293
16,41,19863,19904,1,181,19863,6102
16,41,19863,19904,-1,181,19904,14294
16,87,19904,19991,1,253,19904,6103
16,87,19904,19991,-1,253,19991,14295
16,193,19991,20184,1,244,19991,6104
16,193,19991,20184,-1,244,20184,14296
16,86,20184,20270,1,43,20184,6105
16,86,20184,20270,-1,43,20270,14297
16,108,20270,20378,1,136,20270,6106
16,108,20270,20378,-1,136,20378,14298
16,75,20378,20453,1,162,20378,6107
16,75,20378,20453,-1,162,20453,14299
16,62,20453,20515,1,143,20453,6108
16,62,20453,20515,-1,143,20515,14300
16,180,20515,20695,1,52,20515,6109
16,180,20515,20695,-1,52,20695,14301
16,79,20695,20774,1,87,20695,6110
16,79,20695,20774,-1,87,20774,14302
16,109,20774,20883,1,125,20774,6111
16,109,20774,20883,-1,125,20883,14303
16,200,20883,21083,1,70,20883,6112
16,200,20883,21083,-1,70,21083,14304
16,36,21083,21119,1,131,21083,6113
16,36,21083,21119,-1,131,21119,14305
16,49,21119,21168,1,222,21119,6114
16,49,21119,21168,-1,222,21168,14306
16,124,21168,21292,1,182,21168,6115
16,124,21168,21292,-1,182,21292,14307
16,33,21292,21325,1,96,21292,6116
16,33,21292,21325,-1,96,21325,14308
16,75,21325,21400,1,157,21325,6117
16,75,21325,21400,-1,157,21400,14309
16,50,21400,21450,1,210,21400,6118
16,50,21400,21450,-1,210,21450,14310
16,135,21450,21585,1,253,21450,6119
16,135,21450,21585,-1,253,21585,14311
16,160,21585,21745,1,235,21585,6120
16,160,21585,21745,-1,235,21745,14312
16,84,21745,21829,1,61,21745,6121
16,84,21745,21829,-1,61,21829,14313
16,241,21829,22070,1,239,21829,6122
16,241,21829,22070,-1,239,22070,14314
16,135,22070,22205,1,7,22070,6123
16,135,22070,22205,-1,7,22205,14315
16,119,22205,22324,1,87,22205,6124
16,119,22205,22324,-1,87,22324,14316
16,85,22324,22409,1,24,22324,6125
16,85,22324,22409,-1,24,22409,14317
16,164,22409,22573,1,248,22409,6126
16,164,22409,22573,-1,248,22573,14318
16,51,22573,22624,1,75,22573,6127
16,51,22573,22624,-1,75,22624,14319
16,173,22624,22797,1,233,22624,6128
16,173,22624,22797,-1,233,22797,14320
16,56,22797,22853,1,107,22797,6129
16,56,22797,22853,-1,107,22853,14321
16,97,22853,22950,1,77,22853,6130
16,97,22853,22950,-1,77,22950,14322
16,118,22950,23068,1,199,22950,6131
16,118,22950,23068,-1,199,23068,14323
16,158,23068,23226,1,51,23068,6132
16,158,23068,23226,-1,51,23226,14324
16,80,23226,23306,1,32,23226,6133
16,80,23226,23306,-1,32,23306,14325
16,131,23306,23437,1,181,23306,6134
16,131,23306,23437,-1,181,23437,14326
16,155,23437,23592,1,62,23437,6135
16,155,23437,23592,-1,62,23592,14327
16,147,23592,23739,1,206,23592,6136
16,147,23592,23739,-1,206,23739,14328
16,86,23739,23825,1,204,23739,6137
16,86,23739,23825,-1,204,23825,14329
16,132,23825,23957,1,153,23825,6138
16,132,23825,23957,-1,153,23957,14330
16,64,23957,24021,1,110,23957,6139
16,64,23957,24021,-1,110,24021,14331
16,62,24021,24083,1,251,24021,6140
16,62,24021,24083,-1,251,24083,14332
16,207,24083,24290,1,113,24083,6141
16,207,24083,24290,-1,113,24290,14333
16,52,24290,24342,1,179,24290,6142
16,52,24290,24342,-1,179,24342,14334
16,57,24342,24399,1,147,24342,6143
16,57,24342,24399,-1,147,24399,14335
16,95,24399,24494,1,107,24399,6144
16,95,24399,24494,-1,107,24494,14336
16,197,24494,24691,1,139,24494,6145
16,197,24494,24691,-1,139,24691,14337
16,146,24691,24837,1,225,24691,6146
16,146,24691,24837,-1,225,24837,14338
16,127,24837,24964,1,8,24837,6147
16,127,24837,24964,-1,8,24964,14339
16,104,24964,25068,1,53,24964,6148
16,104,24964,25068,-1,53,25068,14340
16,128,25068,25196,1,252,25068,6149
16,128,25068,25196,-1,252,25196,14341
16,340,25196,25536,1,90,25196,6150
16,340,25196,25536,-1,90,25536,14342
16,65,25536,25601,1,248,25536,6151
16,65,25536,25601,-1,248,25601,14343
16,67,25601,25668,1,25,25601,6152
16,67,25601,25668,-1,25,25668,14344
16,23,25668,25691,1,46,25668,6153
16,23,25668,25691,-1,46,25691,14345
16,85,25691,25776,1,36,25691,6154
16,85,25691,25776,-1,36,25776,14346
16,68,25776,25844,1,221,25776,6155
16,68,25776,25844,-1,221,25844,14347
16,190,25844,26034,1,108,25844,6156
16,190,25844,26034,-1,108,26034,14348
16,179,26034,26213,1,222,26034,6157
16,179,26034,26213,-1,222,26213,14349
16,109,26213,26322,1,202,26213,6158
16,109,26213,26322,-1,202,26322,14350
16,301,26322,26623,1,148,26322,6159
16,301,26322,26623,-1,148,26623,14351
16,58,26623,26681,1,42,26623,6160
16,58,26623,26681,-1,42,26681,14352
16,29,26681,26710,1,175,26681,6161
16,29,26681,26710,-1,175,26710,14353
16,85,26710,26795,1,173,26710,6162
16,85,26710,26795,-1,173,26795,14354
16,75,26795,26870,1,251,26795,6163
16,75,26795,26870,-1,251,26870,14355
16,193,26870,27063,1,130,26870,6164
16,193,26870,27063,-1,130,27063,14356
16,131,27063,27194,1,169,27063,6165
16,131,27063,27194,-1,169,27194,14357
16,84,27194,27278,1,197,27194,6166
16,84,27194,27278,-1,197,27278,14358
16,130,27278,27408,1,81,27278,6167
16,130,27278,27408,-1,81,27408,14359
16,66,27408,27474,1,103,27408,6168
16,66,27408,27474,-1,103,27474,14360
16,60,27474,27534,1,224,27474,6169
16,60,27474,27534,-1,224,27534,14361
16,106,27534,27640,1,205,27534,6170
16,106,27534,27640,-1,205,27640,14362
16,68,27640,27708,1,214,27640,6171
16,68,27640,27708,-1,214,27708,14363
16,120,27708,27828,1,197,27708,6172
16,120,27708,27828,-1,197,27828,14364
16,207,27828,28035,1,94,27828,6173
16,207,27828,28035,-1,94,28035,14365
16,53,28035,28088,1,77,28035,6174
16,53,28035,28088,-1,77,28088,14366
16,62,28088,28150,1,53,28088,6175
16,62,28088,28150,-1,53,28150,14367
16,105,28150,28255,1,203,28150,6176
16,105,28150,28255,-1,203,28255,14368
16,113,28255,28368,1,8,28255,6177
16,113,28255,28368,-1,8,28368,14369
16,65,28368,28433,1,2,28368,6178
16,65,28368,28433,-1,2,28433,14370
16,175,28433,28608,1,173,28433,6179
16,175,28433,28608,-1,173,28608,14371
16,73,28608,28681,1,33,28608,6180
16,73,28608,28681,-1,33,28681,14372
16,92,28681,28773,1,182,28681,6181
16,92,28681,28773,-1,182,28773,14373
16,203,28773,28976,1,155,28773,6182
16,203,28773,28976,-1,155,28976,14374
16,174,28976,29150,1,69,28976,6183
16,174,28976,29150,-1,69,29150,14375
16,119,29150,29269,1,186,29150,6184
16,119,29150,29269,-1,186,29269,14376
16,168,29269,29437,1,246,29269,6185
16,168,29269,29437,-1,246,29437,14377
16,91,29437,29528,1,47,29437,6186
16,91,29437,29528,-1,47,29528,14378
16,79,29528,29607,1,64,29528,6187
16,79,29528,29607,-1,64,29607,14379
16,64,29607,29671,1,244,29607,6188
16,64,29607,29671,-1,244,29671,14380
16,41,29671,29712,1,8,29671,6189
16,41,29671,29712,-1,8,29712,14381
16,203,29712,29915,1,89,29712,6190
16,203,29712,29915,-1,89,29915,14382
16,89,29915,30004,1,144,29915,6191
16,89,29915,30004,-1,144,30004,14383
16,232,30004,30236,1,13,30004,6192
16,232,30004,30236,-1,13,30236,14384
16,210,30236,30446,1,224,30236,6193
16,210,30236,30446,-1,224,30446,14385
16,74,30446,30520,1,160,30446,6194
16,74,30446,30520,-1,160,30520,14386
16,126,30520,30646,1,48,30520,6195
16,126,30520,30646,-1,48,30646,14387
16,201,30646,30847,1,107,30646,6196
16,201,30646,30847,-1,107,30847,14388
16,95,30847,30942,1,52,30847,6197
16,95,30847,30942,-1,52,30942,14389
16,365,30942,31307,1,105,30942,6198
16,365,30942,31307,-1,105,31307,14390
16,121,31307,31428,1,50,31307,6199
16,121,31307,31428,-1,50,31428,14391
16,133,31428,31561,1,175,31428,6200
16,133,31428,31561,-1,175,31561,14392
16,65,31561,31626,1,155,31561,6201
16,65,31561,31626,-1,155,31626,14393
16,172,31626,31798,1,193,31626,6202
16,172,31626,31798,-1,193,31798,14394
16,111,31798,31909,1,135,31798,6203
16,111,31798,31909,-1,135,31909,14395
16,161,31909,32070,1,137,31909,6204
16,161,31909,32070,-1,137,32070,14396
16,108,32070,32178,1,180,32070,6205
16,108,32070,32178,-1,180,32178,14397
17,147,0,147,1,125,0,6481
17,147,0,147,-1,125,147,14673
17,34,147,181,1,207,147,6482
17,34,147,181,-1,207,181,14674
17,109,181,290,1,112,181,6483
17,109,181,290,-1,112,290,14675
17,69,290,359,1,120,290,6484
17,69,290,359,-1,120,359,14676
17,211,359,570,1,170,359,6485
17,211,359,570,-1,170,570,14677
17,79,570,649,1,154,570,6486
17,79,570,649,-1,154,649,14678
17,117,649,766,1,64,649,6487
17,117,649,766,-1,64,766,14679
17,162,766,928,1,140,766,6488
17,162,766,928,-1,140,928,14680
17,50,928,978,1,225,928,6489
17,50,928,978,-1,225,978,14681
17,50,978,1028,1,108,978,6490
17,50,978,1028,-1,108,1028,14682
17,87,1028,1115,1,65,1028,6491
17,87,1028,1115,-1,65,1115,14683
17,95,1115,1210,1,155,1115,6492
17,95,1115,1210,-1,155,1210,14684
17,117,1210,1327,1,61,1210,6493
17,117,1210,1327,-1,61,1327,14685
17,170,1327,1497,1,26,1327,6494
17,170,1327,1497,-1,26,1497,14686
17,149,1497,1646,1,64,1497,6495
17,149,1497,1646,-1,64,1646,14687
17,113,1646,1759,1,216,1646,6496
17,113,1646,1759,-1,216,1759,14688
17,181,1759,1940,1,241,1759,6497
17,181,1759,1940,-1,241,1940,14689
17,230,1940,2170,1,159,1940,6498
17,230,1940,2170,-1,159,2170,14690
17,23,2170,2193,1,256,2170,6499
17,23,2170,2193,-1,256,2193,14691
17,61,2193,2254,1,129,2193,6500
17,61,2193,2254,-1,129,2254,14692
17,92,2254,2346,1,116,2254,6501
17,92,2254,2346,-1,116,2346,14693
17,106,2346,2452,1,90,2346,6502
17,106,2346,2452,-1,90,2452,14694
17,92,2452,2544,1,23,2452,6503
17,92,2452,2544,-1,23,2544,14695
17,189,2544,2733,1,2,2544,6504
17,189,2544,2733,-1,2,2733,14696
17,110,2733,2843,1,88,2733,6505
17,110,2733,2843,-1,88,2843,14697
17,115,2843,2958,1,168,2843,6506
17,115,2843,2958,-1,168,2958,14698
17,118,2958,3076,1,164,2958,6507
17,118,2958,3076,-1,164,3076,14699
17,122,3076,3198,1,212,3076,6508
17,122,3076,3198,-1,212,3198,14700
17,121,3198,3319,1,196,3198,6509
17,121,3198,3319,-1,196,3319,14701
17,116,3319,3435,1,120,3319,6510
17,116,3319,3435,-1,120,3435,14702
17,98,3435,3533,1,11,3435,6511
17,98,3435,3533,-1,11,3533,14703
17,118,3533,3651,1,179,3533,6512
17,118,3533,3651,-1,179,3651,14704
17,76,3651,3727,1,144,3651,6513
17,76,3651,3727,-1,144,3727,14705
17,145,3727,3872,1,31,3727,6514
17,145,3727,3872,-1,31,3872,14706
17,144,3872,4016,1,164,3872,6515
17,144,3872,4016,-1,164,4016,14707
17,15,4016,4031,1,143,4016,6516
17,15,4016,4031,-1,143,4031,14708
17,161,4031,4192,1,235,4031,6517
17,161,4031,4192,-1,235,4192,14709
17,165,4192,4357,1,105,4192,6518
17,165,4192,4357,-1,105,4357,14710
17,125,4357,4482,1,68,4357,6519
17,125,4357,4482,-1,68,4482,14711
17,87,4482,4569,1,229,4482,6520
17,87,4482,4569,-1,229,4569,14712
17,102,4569,4671,1,153,4569,6521
17,102,4569,4671,-1,153,4671,14713
17,110,4671,4781,1,28,4671,6522
17,110,4671,4781,-1,28,4781,14714
17,154,4781,4935,1,67,4781,6523
17,154,4781,4935,-1,67,4935,14715
17,147,4935,5082,1,38,4935,6524
17,147,4935,5082,-1,38,5082,14716
17,133,5082,5215,1,107,5082,6525
17,133,5082,5215,-1,107,5215,14717
17,191,5215,5406,1,50,5215,6526
17,191,5215,5406,-1,50,5406,14718
17,191,5406,5597,1,159,5406,6527
17,191,5406,5597,-1,159,5597,14719
17,80,5597,5677,1,154,5597,6528
17,80,5597,5677,-1,154,5677,14720
17,130,5677,5807,1,40,5677,6529
17,130,5677,5807,-1,40,5807,14721
17,89,5807,5896,1,24,5807,6530
17,89,5807,5896,-1,24,5896,14722
17,50,5896,5946,1,49,5896,6531
17,50,5896,5946,-1,49,5946,14723
17,61,5946,6007,1,239,5946,6532
17,61,5946,6007,-1,239,6007,14724
17,101,6007,6108,1,19,6007,6533
17,101,6007,6108,-1,19,6108,14725
17,25,6108,6133,1,17,6108,6534
17,25,6108,6133,-1,17,6133,14726
17,294,6133,6427,1,202,6133,6535
17,294,6133,6427,-1,202,6427,14727
17,281,6427,6708,1,35,6427,6536
17,281,6427,6708,-1,35,6708,14728
17,238,6708,6946,1,253,6708,6537
17,238,6708,6946,-1,253,6946,14729
17,83,6946,7029,1,74,6946,6538
17,83,6946,7029,-1,74,7029,14730
17,49,7029,7078,1,117,7029,6539
17,49,7029,7078,-1,117,7078,14731
17,81,7078,7159,1,179,7078,6540
17,81,7078,7159,-1,179,7159,14732
17,98,7159,7257,1,111,7159,6541
17,98,7159,7257,-1,111,7257,14733
17,97,7257,7354,1,213,7257,6542
17,97,7257,7354,-1,213,7354,14734
17,243,7354,7597,1,161,7354,6543
17,243,7354,7597,-1,161,7597,14735
17,125,7597,7722,1,144,7597,6544
17,125,7597,7722,-1,144,7722,14736
17,49,7722,7771,1,6,7722,6545
17,49,7722,7771,-1,6,7771,14737
17,108,7771,7879,1,11,7771,6546
17,108,7771,7879,-1,11,7879,14738
17,170,7879,8049,1,244,7879,6547
17,170,7879,8049,-1,244,8049,14739
17,150,8049,8199,1,93,8049,6548
17,150,8049,8199,-1,93,8199,14740
17,25,8199,8224,1,137,8199,6549
17,25,8199,8224,-1,137,8224,14741
17,70,8224,8294,1,171,8224,6550
17,70,8224,8294,-1,171,8294,14742
17,448,8294,8742,1,28,8294,6551
17,448,8294,8742,-1,28,8742,14743
17,218,8742,8960,1,3,8742,6552
17,218,8742,8960,-1,3,8960,14744
17,327,8960,9287,1,97,8960,6553
17,327,8960,9287,-1,97,9287,14745
17,138,9287,9425,1,51,9287,6554
17,138,9287,9425,-1,51,9425,14746
17,232,9425,9657,1,151,9425,6555
17,232,9425,9657,-1,151,9657,14747
17,86,9657,9743,1,208,9657,6556
17,86,9657,9743,-1,208,9743,14748
17,80,9743,9823,1,140,9743,6557
17,80,9743,9823,-1,140,9823,14749
17,205,9823,10028,1,218,9823,6558
17,205,9823,10028,-1,218,10028,14750
17,220,10028,10248,1,243,10028,6559
17,220,10028,10248,-1,243,10248,14751
17,95,10248,10343,1,112,10248,6560
17,95,10248,10343,-1,112,10343,14752
17,64,10343,10407,1,169,10343,6561
17,64,10343,10407,-1,169,10407,14753
17,57,10407,10464,1,183,10407,6562
17,57,10407,10464,-1,183,10464,14754
17,77,10464,10541,1,78,10464,6563
17,77,10464,10541,-1,78,10541,14755
17,65,10541,10606,1,175,10541,6564
17,65,10541,10606,-1,175,10606,14756
17,130,10606,10736,1,115,10606,6565
17,130,10606,10736,-1,115,10736,14757
17,53,10736,10789,1,98,10736,6566
17,53,10736,10789,-1,98,10789,14758
17,134,10789,10923,1,124,10789,6567
17,134,10789,10923,-1,124,10923,14759
17,138,10923,11061,1,183,10923,6568
17,138,10923,11061,-1,183,11061,14760
17,71,11061,11132,1,145,11061,6569
17,71,11061,11132,-1,145,11132,14761
17,121,11132,11253,1,205,11132,6570
17,121,11132,11253,-1,205,11253,14762
17,126,11253,11379,1,68,11253,6571
17,126,11253,11379,-1,68,11379,14763
17,118,11379,11497,1,99,11379,6572
17,118,11379,11497,-1,99,11497,14764
17,88,11497,11585,1,216,11497,6573
17,88,11497,11585,-1,216,11585,14765
17,132,11585,11717,1,235,11585,6574
17,132,11585,11717,-1,235,11717,14766
17,115,11717,11832,1,255,11717,6575
17,115,11717,11832,-1,255,11832,14767
17,147,11832,11979,1,232,11832,6576
17,147,11832,11979,-1,232,11979,14768
17,96,11979,12075,1,234,11979,6577
17,96,11979,12075,-1,234,12075,14769
17,95,12075,12170,1,100,12075,6578
17,95,12075,12170,-1,100,12170,14770
17,112,12170,12282,1,30,12170,6579
17,112,12170,12282,-1,30,12282,14771
17,100,12282,12382,1,224,12282,6580
17,100,12282,12382,-1,224,12382,14772
17,120,12382,12502,1,54,12382,6581
17,120,12382,12502,-1,54,12502,14773
17,158,12502,12660,1,125,12502,6582
17,158,12502,12660,-1,125,12660,14774
17,84,12660,12744,1,166,12660,6583
17,84,12660,12744,-1,166,12744,14775
17,139,12744,12883,1,61,12744,6584
17,139,12744,12883,-1,61,12883,14776
17,116,12883,12999,1,82,12883,6585
17,116,12883,12999,-1,82,12999,14777
17,124,12999,13123,1,45,12999,6586
17,124,12999,13123,-1,45,13123,14778
17,103,13123,13226,1,3,13123,6587
17,103,13123,13226,-1,3,13226,14779
17,30,13226,13256,1,174,13226,6588
17,30,13226,13256,-1,174,13256,14780
17,140,13256,13396,1,176,13256,6589
17,140,13256,13396,-1,176,13396,14781
17,211,13396,13607,1,46,13396,6590
17,211,13396,13607,-1,46,13607,14782
17,166,13607,13773,1,78,13607,6591
17,166,13607,13773,-1,78,13773,14783
17,100,13773,13873,1,215,13773,6592
17,100,13773,13873,-1,215,13873,14784
17,174,13873,14047,1,51,13873,6593
17,174,13873,14047,-1,51,14047,14785
17,233,14047,14280,1,137,14047,6594
17,233,14047,14280,-1,137,14280,14786
17,64,14280,14344,1,109,14280,6595
17,64,14280,14344,-1,109,14344,14787
17,149,14344,14493,1,57,14344,6596
17,149,14344,14493,-1,57,14493,14788
17,64,14493,14557,1,197,14493,6597
17,64,14493,14557,-1,197,14557,14789
17,145,14557,14702,1,35,14557,6598
17,145,14557,14702,-1,35,14702,14790
17,89,14702,14791,1,24,14702,6599
17,89,14702,14791,-1,24,14791,14791
17,146,14791,14937,1,139,14791,6600
17,146,14791,14937,-1,139,14937,14792
17,185,14937,15122,1,152,14937,6601
17,185,14937,15122,-1,152,15122,14793
17,352,15122,15474,1,180,15122,6602
17,352,15122,15474,-1,180,15474,14794
17,213,15474,15687,1,9,15474,6603
17,213,15474,15687,-1,9,15687,14795
17,119,15687,15806,1,204,15687,6604
17,119,15687,15806,-1,204,15806,14796
17,129,15806,15935,1,109,15806,6605
17,129,15806,15935,-1,109,15935,14797
17,47,15935,15982,1,177,15935,6606
17,47,15935,15982,-1,177,15982,14798
17,56,15982,16038,1,56,15982,6607
17,56,15982,16038,-1,56,16038,14799
17,152,16038,16190,1,252,16038,6608
17,152,16038,16190,-1,252,16190,14800
17,181,16190,16371,1,14,16190,6609
17,181,16190,16371,-1,14,16371,14801
17,103,16371,16474,1,86,16371,6610
17,103,16371,16474,-1,86,16474,14802
17,418,16474,16892,1,229,16474,6611
17,418,16474,16892,-1,229,16892,14803
17,84,16892,16976,1,23,16892,6612
17,84,16892,16976,-1,23,16976,14804
17,95,16976,17071,1,181,16976,6613
17,95,16976,17071,-1,181,17071,14805
17,223,17071,17294,1,49,17071,6614
17,223,17071,17294,-1,49,17294,14806
17,146,17294,17440,1,69,17294,6615
17,146,17294,17440,-1,69,17440,14807
17,157,17440,17597,1,249,17440,6616
17,157,17440,17597,-1,249,17597,14808
17,139,17597,17736,1,160,17597,6617
17,139,17597,17736,-1,160,17736,14809
17,62,17736,17798,1,149,17736,6618
17,62,17736,17798,-1,149,17798,14810
17,187,17798,17985,1,185,17798,6619
17,187,17798,17985,-1,185,17985,14811
17,170,17985,18155,1,29,17985,6620
17,170,17985,18155,-1,29,18155,14812
17,269,18155,18424,1,247,18155,6621
17,269,18155,18424,-1,247,18424,14813
17,189,18424,18613,1,166,18424,6622
17,189,18424,18613,-1,166,18613,14814
17,226,18613,18839,1,254,18613,6623
17,226,18613,18839,-1,254,18839,14815
17,36,18839,18875,1,38,18839,6624
17,36,18839,18875,-1,38,18875,14816
17,68,18875,18943,1,74,18875,6625
17,68,18875,18943,-1,74,18943,14817
17,92,18943,19035,1,198,18943,6626
17,92,18943,19035,-1,198,19035,14818
17,90,19035,19125,1,145,19035,6627
17,90,19035,19125,-1,145,19125,14819
17,38,19125,19163,1,204,19125,6628
17,38,19125,19163,-1,204,19163,14820
17,210,19163,19373,1,142,19163,6629
17,210,19163,19373,-1,142,19373,14821
17,108,19373,19481,1,119,19373,6630
17,108,19373,19481,-1,119,19481,14822
17,77,19481,19558,1,253,19481,6631
17,77,19481,19558,-1,253,19558,14823
17,145,19558,19703,1,143,19558,6632
17,145,19558,19703,-1,143,19703,14824
17,157,19703,19860,1,157,19703,6633
17,157,19703,19860,-1,157,19860,14825
17,205,19860,20065,1,151,19860,6634
17,205,19860,20065,-1,151,20065,14826
17,121,20065,20186,1,81,20065,6635
17,121,20065,20186,-1,81,20186,14827
17,62,20186,20248,1,99,20186,6636
17,62,20186,20248,-1,99,20248,14828
17,152,20248,20400,1,125,20248,6637
17,152,20248,20400,-1,125,20400,14829
17,130,20400,20530,1,212,20400,6638
17,130,20400,20530,-1,212,20530,14830
17,56,20530,20586,1,113,20530,6639
17,56,20530,20586,-1,113,20586,14831
17,115,20586,20701,1,101,20586,6640
17,115,20586,20701,-1,101,20701,14832
17,158,20701,20859,1,50,20701,6641
17,158,20701,20859,-1,50,20859,14833
17,90,20859,20949,1,29,20859,6642
17,90,20859,20949,-1,29,20949,14834
17,118,20949,21067,1,238,20949,6643
17,118,20949,21067,-1,238,21067,14835
17,104,21067,21171,1,221,21067,6644
17,104,21067,21171,-1,221,21171,14836
17,145,21171,21316,1,1,21171,6645
17,145,21171,21316,-1,1,21316,14837
17,307,21316,21623,1,152,21316,6646
17,307,21316,21623,-1,152,21623,14838
17,80,21623,21703,1,174,21623,6647
17,80,21623,21703,-1,174,21703,14839
17,54,21703,21757,1,90,21703,6648
17,54,21703,21757,-1,90,21757,14840
17,228,21757,21985,1,45,21757,6649
17,228,21757,21985,-1,45,21985,14841
17,182,21985,22167,1,33,21985,6650
17,182,21985,22167,-1,33,22167,14842
17,127,22167,22294,1,179,22167,6651
17,127,22167,22294,-1,179,22294,14843
17,24,22294,22318,1,37,22294,6652
17,24,22294,22318,-1,37,22318,14844
17,101,22318,22419,1,202,22318,6653
17,101,22318,22419,-1,202,22419,14845
17,151,22419,22570,1,45,22419,6654
17,151,22419,22570,-1,45,22570,14846
17,129,22570,22699,1,154,22570,6655
17,129,22570,22699,-1,154,22699,14847
17,75,22699,22774,1,27,22699,6656
17,75,22699,22774,-1,27,22774,14848
17,145,22774,22919,1,246,22774,6657
17,145,22774,22919,-1,246,22919,14849
17,261,22919,23180,1,136,22919,6658
17,261,22919,23180,-1,136,23180,14850
17,96,23180,23276,1,82,23180,6659
17,96,23180,23276,-1,82,23276,14851
17,104,23276,23380,1,151,23276,6660
17,104,23276,23380,-1,151,23380,14852
17,96,23380,23476,1,174,23380,6661
17,96,23380,23476,-1,174,23476,14853
17,100,23476,23576,1,129,23476,6662
17,100,23476,23576,-1,129,23576,14854
17,175,23576,23751,1,227,23576,6663
17,175,23576,23751,-1,227,23751,14855
17,184,23751,23935,1,222,23751,6664
17,184,23751,23935,-1,222,23935,14856
17,130,23935,24065,1,55,23935,6665
17,130,23935,24065,-1,55,24065,14857
17,31,24065,24096,1,201,24065,6666
17,31,24065,24096,-1,201,24096,14858
17,126,24096,24222,1,82,24096,6667
17,126,24096,24222,-1,82,24222,14859
17,11,24222,24233,1,142,24222,6668
17,11,24222,24233,-1,142,24233,14860
17,170,24233,24403,1,169,24233,6669
17,170,24233,24403,-1,169,24403,14861
17,69,24403,24472,1,83,24403,6670
17,69,24403,24472,-1,83,24472,14862
17,92,24472,24564,1,12,24472,6671
17,92,24472,24564,-1,12,24564,14863
17,193,24564,24757,1,45,24564,6672
17,193,24564,24757,-1,45,24757,14864
17,177,24757,24934,1,75,24757,6673
17,177,24757,24934,-1,75,24934,14865
17,162,24934,25096,1,225,24934,6674
17,162,24934,25096,-1,225,25096,14866
17,103,25096,25199,1,142,25096,6675
17,103,25096,25199,-1,142,25199,14867
17,92,25199,25291,1,109,25199,6676
17,92,25199,25291,-1,109,25291,14868
17,186,25291,25477,1,113,25291,6677
17,186,25291,25477,-1,113,25477,14869
17,205,25477,25682,1,87,25477,6678
17,205,25477,25682,-1,87,25682,14870
17,19,25682,25701,1,74,25682,6679
17,19,25682,25701,-1,74,25701,14871
17,79,25701,25780,1,24,25701,6680
17,79,25701,25780,-1,24,25780,14872
17,87,25780,25867,1,13,25780,6681
17,87,25780,25867,-1,13,25867,14873
17,144,25867,26011,1,104,25867,6682
17,144,25867,26011,-1,104,26011,14874
17,66,26011,26077,1,230,26011,6683
17,66,26011,26077,-1,230,26077,14875
17,232,26077,26309,1,255,26077,6684
17,232,26077,26309,-1,255,26309,14876
17,148,26309,26457,1,148,26309,6685
17,148,26309,26457,-1,148,26457,14877
17,141,26457,26598,1,180,26457,6686
17,141,26457,26598,-1,180,26598,14878
17,111,26598,26709,1,120,26598,6687
17,111,26598,26709,-1,120,26709,14879
17,42,26709,26751,1,156,26709,6688
17,42,26709,26751,-1,156,26751,14880
17,56,26751,26807,1,159,26751,6689
17,56,26751,26807,-1,159,26807,14881
17,163,26807,26970,1,128,26807,6690
17,163,26807,26970,-1,128,26970,14882
17,89,26970,27059,1,160,26970,6691
17,89,26970,27059,-1,160,27059,14883
17,100,27059,27159,1,194,27059,6692
17,100,27059,27159,-1,194,27159,14884
17,379,27159,27538,1,20,27159,6693
17,379,27159,27538,-1,20,27538,14885
17,136,27538,27674,1,65,27538,6694
17,136,27538,27674,-1,65,27674,14886
17,131,27674,27805,1,56,27674,6695
17,131,27674,27805,-1,56,27805,14887
17,206,27805,28011,1,23,27805,6696
17,206,27805,28011,-1,23,28011,14888
17,83,28011,28094,1,90,28011,6697
17,83,28011,28094,-1,90,28094,14889
17,73,28094,28167,1,110,28094,6698
17,73,28094,28167,-1,110,28167,14890
17,58,28167,28225,1,55,28167,6699
17,58,28167,28225,-1,55,28225,14891
17,136,28225,28361,1,45,28225,6700
17,136,28225,28361,-1,45,28361,14892
17,243,28361,28604,1,240,28361,6701
17,243,28361,28604,-1,240,28604,14893
17,77,28604,28681,1,2,28604,6702
17,77,28604,28681,-1,2,28681,14894
17,128,28681,28809,1,181,28681,6703
17,128,28681,28809,-1,181,28809,14895
17,249,28809,29058,1,90,28809,6704
17,249,28809,29058,-1,90,29058,14896
17,174,29058,29232,1,201,29058,6705
17,174,29058,29232,-1,201,29232,14897
17,97,29232,29329,1,159,29232,6706
17,97,29232,29329,-1,159,29329,14898
17,160,29329,29489,1,70,29329,6707
17,160,29329,29489,-1,70,29489,14899
17,54,29489,29543,1,1,29489,6708
17,54,29489,29543,-1,1,29543,14900
17,72,29543,29615,1,248,29543,6709
17,72,29543,29615,-1,248,29615,14901
17,143,29615,29758,1,54,29615,6710
17,143,29615,29758,-1,54,29758,14902
17,76,29758,29834,1,53,29758,6711
17,76,29758,29834,-1,53,29834,14903
17,147,29834,29981,1,138,29834,6712
17,147,29834,29981,-1,138,29981,14904
17,97,29981,30078,1,206,29981,6713
17,97,29981,30078,-1,206,30078,14905
17,190,30078,30268,1,89,30078,6714
17,190,30078,30268,-1,89,30268,14906
17,60,30268,30328,1,13,30268,6715
17,60,30268,30328,-1,13,30328,14907
17,83,30328,30411,1,163,30328,6716
17,83,30328,30411,-1,163,30411,14908
17,142,30411,30553,1,124,30411,6717
17,142,30411,30553,-1,124,30553,14909
17,197,30553,30750,1,84,30553,6718
17,197,30553,30750,-1,84,30750,14910
17,73,30750,30823,1,116,30750,6719
17,73,30750,30823,-1,116,30823,14911
17,287,30823,31110,1,120,30823,6720
17,287,30823,31110,-1,120,31110,14912
17,102,31110,31212,1,13,31110,6721
17,102,31110,31212,-1,13,31212,14913
17,69,31212,31281,1,153,31212,6722
17,69,31212,31281,-1,153,31281,14914
17,276,31281,31557,1,146,31281,6723
17,276,31281,31557,-1,146,31557,14915
17,64,31557,31621,1,84,31557,6724
17,64,31557,31621,-1,84,31621,14916
17,95,31621,31716,1,194,31621,6725
17,95,31621,31716,-1,194,31716,14917
17,120,31716,31836,1,245,31716,6726
17,120,31716,31836,-1,245,31836,14918
17,121,31836,31957,1,98,31836,6727
17,121,31836,31957,-1,98,31957,14919
17,114,31957,32071,1,170,31957,6728
17,114,31957,32071,-1,170,32071,14920
17,98,32071,32169,1,151,32071,6729
17,98,32071,32169,-1,151,32169,14921
17,178,32169,32347,1,46,32169,6730
17,178,32169,32347,-1,46,32347,14922
17,92,32347,32439,1,189,32347,6731
17,92,32347,32439,-1,189,32439,14923
17,73,32439,32512,1,52,32439,6732
17,73,32439,32512,-1,52,32512,14924
17,74,32512,32586,1,206,32512,6733
17,74,32512,32586,-1,206,32586,14925
17,242,32586,32828,1,165,32586,6734
17,242,32586,32828,-1,165,32828,14926
17,127,32828,32955,1,246,32828,6735
17,127,32828,32955,-1,246,32955,14927
17,88,32955,33043,1,192,32955,6736
17,88,32955,33043,-1,192,33043,14928
17,31,33043,33074,1,141,33043,6737
17,31,33043,33074,-1,141,33074,14929
18,85,0,85,1,8,0,5675
18,85,0,85,-1,8,85,13867
18,126,85,211,1,182,85,5676
18,126,85,211,-1,182,211,13868
18,179,211,390,1,179,211,5677
18,179,211,390,-1,179,390,13869
18,168,390,558,1,3,390,5678
18,168,390,558,-1,3,558,13870
18,64,558,622,1,208,558,5679
18,64,558,622,-1,208,622,13871
18,74,622,696,1,5,622,5680
18,74,622,696,-1,5,696,13872
18,190,696,886,1,110,696,5681
18,190,696,886,-1,110,886,13873
18,333,886,1219,1,243,886,5682
18,333,886,1219,-1,243,1219,13874
18,63,1219,1282,1,169,1219,5683
18,63,1219,1282,-1,169,1282,13875
18,166,1282,1448,1,92,1282,5684
18,166,1282,1448,-1,92,1448,13876
18,194,1448,1642,1,35,1448,5685
18,194,1448,1642,-1,35,1642,13877
18,303,1642,1945,1,198,1642,5686
18,303,1642,1945,-1,198,1945,13878
18,102,1945,2047,1,141,1945,5687
18,102,1945,2047,-1,141,2047,13879
18,177,2047,2224,1,126,2047,5688
18,177,2047,2224,-1,126,2224,13880
18,86,2224,2310,1,180,2224,5689
18,86,2224,2310,-1,180,2310,13881
18,171,2310,2481,1,174,2310,5690
18,171,2310,2481,-1,174,2481,13882
18,73,2481,2554,1,237,2481,5691
18,73,2481,2554,-1,237,2554,13883
18,126,2554,2680,1,32,2554,5692
18,126,2554,2680,-1,32,2680,13884
18,120,2680,2800,1,206,2680,5693
18,120,2680,2800,-1,206,2800,13885
18,119,2800,2919,1,208,2800,5694
18,119,2800,2919,-1,208,2919,13886
18,32,2919,2951,1,88,2919,5695
18,32,2919,2951,-1,88,2951,13887
18,72,2951,3023,1,248,2951,5696
18,72,2951,3023,-1,248,3023,13888
18,179,3023,3202,1,172,3023,5697
18,179,3023,3202,-1,172,3202,13889
18,78,3202,3280,1,144,3202,5698
18,78,3202,3280,-1,144,3280,13890
18,346,3280,3626,1,249,3280,5699
18,346,3280,3626,-1,249,3626,13891
18,154,3626,3780,1,74,3626,5700
18,154,3626,3780,-1,74,3780,13892
18,172,3780,3952,1,4,3780,5701
18,172,3780,3952,-1,4,3952,13893
18,90,3952,4042,1,186,3952,5702
18,90,3952,4042,-1,186,4042,13894
18,91,4042,4133,1,109,4042,5703
18,91,4042,4133,-1,109,4133,13895
18,230,4133,4363,1,125,4133,5704
18,230,4133,4363,-1,125,4363,13896
18,87,4363,4450,1,105,4363,5705
18,87,4363,4450,-1,105,4450,13897
18,198,4450,4648,1,217,4450,5706
18,198,4450,4648,-1,217,4648,13898
18,56,4648,4704,1,92,4648,5707
18,56,4648,4704,-1,92,4704,13899
18,126,4704,4830,1,85,4704,5708
18,126,4704,4830,-1,85,4830,13900
18,113,4830,4943,1,130,4830,5709
18,113,4830,4943,-1,130,4943,13901
18,193,4943,5136,1,213,4943,5710
18,193,4943,5136,-1,213,5136,13902
18,62,5136,5198,1,238,5136,5711
18,62,5136,5198,-1,238,5198,13903
18,29,5198,5227,1,105,5198,5712
18,29,5198,5227,-1,105,5227,13904
18,193,5227,5420,1,192,5227,5713
18,193,5227,5420,-1,192,5420,13905
18,91,5420,5511,1,15,5420,5714
18,91,5420,5511,-1,15,5511,13906
18,128,5511,5639,1,178,5511,5715
18,128,5511,5639,-1,178,5639,13907
18,83,5639,5722,1,64,5639,5716
18,83,5639,5722,-1,64,5722,13908
18,98,5722,5820,1,32,5722,5717
18,98,5722,5820,-1,32,5820,13909
18,125,5820,5945,1,75,5820,5718
18,125,5820,5945,-1,75,5945,13910
18,32,5945,5977,1,155,5945,5719
18,32,5945,5977,-1,155,5977,13911
18,59,5977,6036,1,132,5977,5720
18,59,5977,6036,-1,132,6036,13912
18,239,6036,6275,1,99,6036,5721
18,239,6036,6275,-1,99,6275,13913
18,195,6275,6470,1,103,6275,5722
18,195,6275,6470,-1,103,6470,13914
18,178,6470,6648,1,18,6470,5723
18,178,6470,6648,-1,18,6648,13915
18,279,6648,6927,1,50,6648,5724
18,279,6648,6927,-1,50,6927,13916
18,119,6927,7046,1,204,6927,5725
18,119,6927,7046,-1,204,7046,13917
18,267,7046,7313,1,79,7046,5726
18,267,7046,7313,-1,79,7313,13918
18,67,7313,7380,1,193,7313,5727
18,67,7313,7380,-1,193,7380,13919
18,119,7380,7499,1,86,7380,5728
18,119,7380,7499,-1,86,7499,13920
18,204,7499,7703,1,175,7499,5729
18,204,7499,7703,-1,175,7703,13921
18,130,7703,7833,1,121,7703,5730
18,130,7703,7833,-1,121,7833,13922
18,91,7833,7924,1,185,7833,5731
18,91,7833,7924,-1,185,7924,13923
18,121,7924,8045,1,158,7924,5732
18,121,7924,8045,-1,158,8045,13924
18,74,8045,8119,1,216,8045,5733
18,74,8045,8119,-1,216,8119,13925
18,134,8119,8253,1,91,8119,5734
18,134,8119,8253,-1,91,8253,13926
18,114,8253,8367,1,192,8253,5735
18,114,8253,8367,-1,192,8367,13927
18,174,8367,8541,1,218,8367,5736
18,174,8367,8541,-1,218,8541,13928
18,129,8541,8670,1,199,8541,5737
18,129,8541,8670,-1,199,8670,13929
18,95,8670,8765,1,106,8670,5738
18,95,8670,8765,-1,106,8765,13930
18,138,8765,8903,1,11,8765,5739
18,138,8765,8903,-1,11,8903,13931
18,183,8903,9086,1,229,8903,5740
18,183,8903,9086,-1,229,9086,13932
18,74,9086,9160,1,247,9086,5741
18,74,9086,9160,-1,247,9160,13933
18,82,9160,9242,1,89,9160,5742
18,82,9160,9242,-1,89,9242,13934
18,311,9242,9553,1,82,9242,5743
18,311,9242,9553,-1,82,9553,13935
18,106,9553,9659,1,189,9553,5744
18,106,9553,9659,-1,189,9659,13936
18,115,9659,9774,1,160,9659,5745
18,115,9659,9774,-1,160,9774,13937
18,130,9774,9904,1,154,9774,5746
18,130,9774,9904,-1,154,9904,13938
18,106,9904,10010,1,73,9904,5747
18,106,9904,10010,-1,73,10010,13939
18,158,10010,10168,1,226,10010,5748
18,158,10010,10168,-1,226,10168,13940
18,145,10168,10313,1,83,10168,5749
18,145,10168,10313,-1,83,10313,13941
18,81,10313,10394,1,15,10313,5750
18,81,10313,10394,-1,15,10394,13942
18,350,10394,10744,1,47,10394,5751
18,350,10394,10744,-1,47,10744,13943
18,91,10744,10835,1,61,10744,5752
18,91,10744,10835,-1,61,10835,13944
18,41,10835,10876,1,194,10835,5753
18,41,10835,10876,-1,194,10876,13945
18,153,10876,11029,1,148,10876,5754
18,153,10876,11029,-1,148,11029,13946
18,93,11029,11122,1,238,11029,5755
18,93,11029,11122,-1,238,11122,13947
18,127,11122,11249,1,78,11122,5756
18,127,11122,11249,-1,78,11249,13948
18,112,11249,11361,1,1,11249,5757
18,112,11249,11361,-1,1,11361,13949
18,288,11361,11649,1,229,11361,5758
18,288,11361,11649,-1,229,11649,13950
18,118,11649,11767,1,203,11649,5759
18,118,11649,11767,-1,203,11767,13951
18,125,11767,11892,1,256,11767,5760
18,125,11767,11892,-1,256,11892,13952
18,71,11892,11963,1,15,11892,5761
18,71,11892,11963,-1,15,11963,13953
18,82,11963,12045,1,205,11963,5762
18,82,11963,12045,-1,205,12045,13954
18,66,12045,12111,1,10,12045,5763
18,66,12045,12111,-1,10,12111,13955
18,112,12111,12223,1,137,12111,5764
18,112,12111,12223,-1,137,12223,13956
18,111,12223,12334,1,67,12223,5765
18,111,12223,12334,-1,67,12334,13957
18,93,12334,12427,1,213,12334,5766
18,93,12334,12427,-1,213,12427,13958
18,199,12427,12626,1,10,12427,5767
18,199,12427,12626,-1,10,12626,13959
18,65,12626,12691,1,49,12626,5768
18,65,12626,12691,-1,49,12691,13960
18,140,12691,12831,1,27,12691,5769
18,140,12691,12831,-1,27,12831,13961
18,81,12831,12912,1,159,12831,5770
18,81,12831,12912,-1,159,12912,13962
18,34,12912,12946,1,235,12912,5771
18,34,12912,12946,-1,235,12946,13963
18,190,12946,13136,1,103,12946,5772
18,190,12946,13136,-1,103,13136,13964
18,141,13136,13277,1,55,13136,5773
18,141,13136,13277,-1,55,13277,13965
18,96,13277,13373,1,101,13277,5774
18,96,13277,13373,-1,101,13373,13966
18,104,13373,13477,1,254,13373,5775
18,104,13373,13477,-1,254,13477,13967
18,96,13477,13573,1,143,13477,5776
18,96,13477,13573,-1,143,13573,13968
18,242,13573,13815,1,249,13573,5777
18,242,13573,13815,-1,249,13815,13969
18,171,13815,13986,1,144,13815,5778
18,171,13815,13986,-1,144,13986,13970
18,185,13986,14171,1,80,13986,5779
18,185,13986,14171,-1,80,14171,13971
18,47,14171,14218,1,137,14171,5780
18,47,14171,14218,-1,137,14218,13972
18,86,14218,14304,1,97,14218,5781
18,86,14218,14304,-1,97,14304,13973
18,256,14304,14560,1,97,14304,5782
18,256,14304,14560,-1,97,14560,13974
18,131,14560,14691,1,22,14560,5783
18,131,14560,14691,-1,22,14691,13975
18,209,14691,14900,1,249,14691,5784
18,209,14691,14900,-1,249,14900,13976
18,91,14900,14991,1,24,14900,5785
18,91,14900,14991,-1,24,14991,13977
18,53,14991,15044,1,144,14991,5786
18,53,14991,15044,-1,144,15044,13978
18,72,15044,15116,1,88,15044,5787
18,72,15044,15116,-1,88,15116,13979
18,122,15116,15238,1,231,15116,5788
18,122,15116,15238,-1,231,15238,13980
18,73,15238,15311,1,220,15238,5789
18,73,15238,15311,-1,220,15311,13981
18,77,15311,15388,1,110,15311,5790
18,77,15311,15388,-1,110,15388,13982
18,164,15388,15552,1,223,15388,5791
18,164,15388,15552,-1,223,15552,13983
18,128,15552,15680,1,215,15552,5792
18,128,15552,15680,-1,215,15680,13984
18,117,15680,15797,1,167,15680,5793
18,117,15680,15797,-1,167,15797,13985
18,255,15797,16052,1,232,15797,5794
18,255,15797,16052,-1,232,16052,13986
18,45,16052,16097,1,26,16052,5795
18,45,16052,16097,-1,26,16097,13987
18,129,16097,16226,1,190,16097,5796
18,129,16097,16226,-1,190,16226,13988
18,168,16226,16394,1,87,16226,5797
18,168,16226,16394,-1,87,16394,13989
18,175,16394,16569,1,251,16394,5798
18,175,16394,16569,-1,251,16569,13990
18,182,16569,16751,1,208,16569,5799
18,182,16569,16751,-1,208,16751,13991
18,56,16751,16807,1,238,16751,5800
18,56,16751,16807,-1,238,16807,13992
18,30,16807,16837,1,137,16807,5801
18,30,16807,16837,-1,137,16837,13993
18,84,16837,16921,1,103,16837,5802
18,84,16837,16921,-1,103,16921,13994
18,249,16921,17170,1,31,16921,5803
18,249,16921,17170,-1,31,17170,13995
18,90,17170,17260,1,70,17170,5804
18,90,17170,17260,-1,70,17260,13996
18,128,17260,17388,1,147,17260,5805
18,128,17260,17388,-1,147,17388,13997
18,46,17388,17434,1,61,17388,5806
18,46,17388,17434,-1,61,17434,13998
18,140,17434,17574,1,244,17434,5807
18,140,17434,17574,-1,244,17574,13999
18,183,17574,17757,1,179,17574,5808
18,183,17574,17757,-1,179,17757,14000
18,38,17757,17795,1,167,17757,5809
18,38,17757,17795,-1,167,17795,14001
18,130,17795,17925,1,41,17795,5810
18,130,17795,17925,-1,41,17925,14002
18,62,17925,17987,1,84,17925,5811
18,62,17925,17987,-1,84,17987,14003
18,182,17987,18169,1,73,17987,5812
18,182,17987,18169,-1,73,18169,14004
18,102,18169,18271,1,190,18169,5813
18,102,18169,18271,-1,190,18271,14005
18,192,18271,18463,1,201,18271,5814
18,192,18271,18463,-1,201,18463,14006
18,196,18463,18659,1,50,18463,5815
18,196,18463,18659,-1,50,18659,14007
18,95,18659,18754,1,86,18659,5816
18,95,18659,18754,-1,86,18754,14008
18,119,18754,18873,1,20,18754,5817
18,119,18754,18873,-1,20,18873,14009
18,115,18873,18988,1,91,18873,5818
18,115,18873,18988,-1,91,18988,14010
18,122,18988,19110,1,206,18988,5819
18,122,18988,19110,-1,206,19110,14011
18,111,19110,19221,1,190,19110,5820
18,111,19110,19221,-1,190,19221,14012
18,100,19221,19321,1,84,19221,5821
18,100,19221,19321,-1,84,19321,14013
18,69,19321,19390,1,207,19321,5822
18,69,19321,19390,-1,207,19390,14014
18,110,19390,19500,1,19,19390,5823
18,110,19390,19500,-1,19,19500,14015
18,187,19500,19687,1,118,19500,5824
18,187,19500,19687,-1,118,19687,14016
18,136,19687,19823,1,15,19687,5825
18,136,19687,19823,-1,15,19823,14017
18,157,19823,19980,1,238,19823,5826
18,157,19823,19980,-1,238,19980,14018
18,33,19980,20013,1,238,19980,5827
18,33,19980,20013,-1,238,20013,14019
18,118,20013,20131,1,169,20013,5828
18,118,20013,20131,-1,169,20131,14020
18,95,20131,20226,1,65,20131,5829
18,95,20131,20226,-1,65,20226,14021
18,307,20226,20533,1,193,20226,5830
18,307,20226,20533,-1,193,20533,14022
18,157,20533,20690,1,189,20533,5831
18,157,20533,20690,-1,189,20690,14023
18,100,20690,20790,1,158,20690,5832
18,100,20690,20790,-1,158,20790,14024
18,205,20790,20995,1,166,20790,5833
18,205,20790,20995,-1,166,20995,14025
18,168,20995,21163,1,49,20995,5834
18,168,20995,21163,-1,49,21163,14026
18,229,21163,21392,1,10,21163,5835
18,229,21163,21392,-1,10,21392,14027
18,88,21392,21480,1,231,21392,5836
18,88,21392,21480,-1,231,21480,14028
18,155,21480,21635,1,68,21480,5837
18,155,21480,21635,-1,68,21635,14029
18,119,21635,21754,1,133,21635,5838
18,119,21635,21754,-1,133,21754,14030
18,112,21754,21866,1,35,21754,5839
18,112,21754,21866,-1,35,21866,14031
18,166,21866,22032,1,247,21866,5840
18,166,21866,22032,-1,247,22032,14032
18,162,22032,22194,1,21,22032,5841
18,162,22032,22194,-1,21,22194,14033
18,174,22194,22368,1,204,22194,5842
18,174,22194,22368,-1,204,22368,14034
18,160,22368,22528,1,30,22368,5843
18,160,22368,22528,-1,30,22528,14035
18,290,22528,22818,1,9,22528,5844
18,290,22528,22818,-1,9,22818,14036
18,168,22818,22986,1,80,22818,5845
18,168,22818,22986,-1,80,22986,14037
18,169,22986,23155,1,42,22986,5846
18,169,22986,23155,-1,42,23155,14038
18,131,23155,23286,1,215,23155,5847
18,131,23155,23286,-1,215,23286,14039
18,237,23286,23523,1,50,23286,5848
18,237,23286,23523,-1,50,23523,14040
18,69,23523,23592,1,248,23523,5849
18,69,23523,23592,-1,248,23592,14041
18,232,23592,23824,1,210,23592,5850
18,232,23592,23824,-1,210,23824,14042
18,133,23824,23957,1,248,23824,5851
18,133,23824,23957,-1,248,23957,14043
18,67,23957,24024,1,65,23957,5852
18,67,23957,24024,-1,65,24024,14044
18,134,24024,24158,1,118,24024,5853
18,134,24024,24158,-1,118,24158,14045
18,31,24158,24189,1,241,24158,5854
18,31,24158,24189,-1,241,24189,14046
18,115,24189,24304,1,146,24189,5855
18,115,24189,24304,-1,146,24304,14047
18,241,24304,24545,1,58,24304,5856
18,241,24304,24545,-1,58,24545,14048
18,112,24545,24657,1,183,24545,5857
18,112,24545,24657,-1,183,24657,14049
18,143,24657,24800,1,132,24657,5858
18,143,24657,24800,-1,132,24800,14050
18,66,24800,24866,1,108,24800,5859
18,66,24800,24866,-1,108,24866,14051
18,256,24866,25122,1,127,24866,5860
18,256,24866,25122,-1,127,25122,14052
18,66,25122,25188,1,65,25122,5861
18,66,25122,25188,-1,65,25188,14053
18,99,25188,25287,1,91,25188,5862
18,99,25188,25287,-1,91,25287,14054
18,215,25287,25502,1,133,25287,5863
18,215,25287,25502,-1,133,25502,14055
18,70,25502,25572,1,126,25502,5864
18,70,25502,25572,-1,126,25572,14056
18,217,25572,25789,1,85,25572,5865
18,217,25572,25789,-1,85,25789,14057
18,199,25789,25988,1,75,25789,5866
18,199,25789,25988,-1,75,25988,14058
18,77,25988,26065,1,235,25988,5867
18,77,25988,26065,-1,235,26065,14059
18,20,26065,26085,1,107,26065,5868
18,20,26065,26085,-1,107,26085,14060
18,64,26085,26149,1,1,26085,5869
18,64,26085,26149,-1,1,26149,14061
18,177,26149,26326,1,220,26149,5870
18,177,26149,26326,-1,220,26326,14062
18,209,26326,26535,1,41,26326,5871
18,209,26326,26535,-1,41,26535,14063
18,194,26535,26729,1,64,26535,5872
18,194,26535,26729,-1,64,26729,14064
18,370,26729,27099,1,88,26729,5873
18,370,26729,27099,-1,88,27099,14065
18,117,27099,27216,1,114,27099,5874
18,117,27099,27216,-1,114,27216,14066
18,77,27216,27293,1,157,27216,5875
18,77,27216,27293,-1,157,27293,14067
18,114,27293,27407,1,190,27293,5876
18,114,27293,27407,-1,190,27407,14068
18,130,27407,27537,1,80,27407,5877
18,130,27407,27537,-1,80,27537,14069
18,78,27537,27615,1,24,27537,5878
18,78,27537,27615,-1,24,27615,14070
18,94,27615,27709,1,4,27615,5879
18,94,27615,27709,-1,4,27709,14071
18,58,27709,27767,1,74,27709,5880
18,58,27709,27767,-1,74,27767,14072
18,162,27767,27929,1,76,27767,5881
18,162,27767,27929,-1,76,27929,14073
18,121,27929,28050,1,11,27929,5882
18,121,27929,28050,-1,11,28050,14074
18,180,28050,28230,1,156,28050,5883
18,180,28050,28230,-1,156,28230,14075
18,36,28230,28266,1,233,28230,5884
18,36,28230,28266,-1,233,28266,14076
18,104,28266,28370,1,26,28266,5885
18,104,28266,28370,-1,26,28370,14077
18,63,28370,28433,1,171,28370,5886
18,63,28370,28433,-1,171,28433,14078
18,246,28433,28679,1,241,28433,5887
18,246,28433,28679,-1,241,28679,14079
18,135,28679,28814,1,177,28679,5888
18,135,28679,28814,-1,177,28814,14080
18,118,28814,28932,1,213,28814,5889
18,118,28814,28932,-1,213,28932,14081
18,177,28932,29109,1,115,28932,5890
18,177,28932,29109,-1,115,29109,14082
18,87,29109,29196,1,177,29109,5891
18,87,29109,29196,-1,177,29196,14083
18,110,29196,29306,1,122,29196,5892
18,110,29196,29306,-1,122,29306,14084
18,38,29306,29344,1,104,29306,5893
18,38,29306,29344,-1,104,29344,14085
18,60,29344,29404,1,45,29344,5894
18,60,29344,29404,-1,45,29404,14086
18,82,29404,29486,1,242,29404,5895
18,82,29404,29486,-1,242,29486,14087
18,74,29486,29560,1,42,29486,5896
18,74,29486,29560,-1,42,29560,14088
18,152,29560,29712,1,161,29560,5897
18,152,29560,29712,-1,161,29712,14089
18,79,29712,29791,1,45,29712,5898
18,79,29712,29791,-1,45,29791,14090
18,130,29791,29921,1,123,29791,5899
18,130,29791,29921,-1,123,29921,14091
18,72,29921,29993,1,18,29921,5900
18,72,29921,29993,-1,18,29993,14092
18,110,29993,30103,1,232,29993,5901
18,110,29993,30103,-1,232,30103,14093
18,112,30103,30215,1,170,30103,5902
18,112,30103,30215,-1,170,30215,14094
18,134,30215,30349,1,37,30215,5903
18,134,30215,30349,-1,37,30349,14095
18,146,30349,30495,1,206,30349,5904
18,146,30349,30495,-1,206,30495,14096
18,179,30495,30674,1,227,30495,5905
18,179,30495,30674,-1,227,30674,14097
18,135,30674,30809,1,142,30674,5906
18,135,30674,30809,-1,142,30809,14098
18,123,30809,30932,1,133,30809,5907
18,123,30809,30932,-1,133,30932,14099
18,152,30932,31084,1,143,30932,5908
18,152,30932,31084,-1,143,31084,14100
18,67,31084,31151,1,46,31084,5909
18,67,31084,31151,-1,46,31151,14101
18,96,31151,31247,1,207,31151,5910
18,96,31151,31247,-1,207,31247,14102
18,137,31247,31384,1,126,31247,5911
18,137,31247,31384,-1,126,31384,14103
18,85,31384,31469,1,224,31384,5912
18,85,31384,31469,-1,224,31469,14104
18,181,31469,31650,1,111,31469,5913
18,181,31469,31650,-1,111,31650,14105
18,148,31650,31798,1,255,31650,5914
18,148,31650,31798,-1,255,31798,14106
18,62,31798,31860,1,152,31798,5915
18,62,31798,31860,-1,152,31860,14107
18,263,31860,32123,1,141,31860,5916
18,263,31860,32123,-1,141,32123,14108
18,386,32123,32509,1,179,32123,5917
18,386,32123,32509,-1,179,32509,14109
18,157,32509,32666,1,198,32509,5918
18,157,32509,32666,-1,198,32666,14110
18,85,32666,32751,1,181,32666,5919
18,85,32666,32751,-1,181,32751,14111
18,86,32751,32837,1,246,32751,5920
18,86,32751,32837,-1,246,32837,14112
18,90,32837,32927,1,169,32837,5921
18,90,32837,32927,-1,169,32927,14113
18,123,32927,33050,1,92,32927,5922
18,123,32927,33050,-1,92,33050,14114
18,128,33050,33178,1,74,33050,5923
18,128,33050,33178,-1,74,33178,14115
18,77,33178,33255,1,57,33178,5924
18,77,33178,33255,-1,57,33255,14116
18,102,33255,33357,1,231,33255,5925
18,102,33255,33357,-1,231,33357,14117
18,198,33357,33555,1,60,33357,5926
18,198,33357,33555,-1,60,33555,14118
18,203,33555,33758,1,169,33555,5927
18,203,33555,33758,-1,169,33758,14119
18,64,33758,33822,1,24,33758,5928
18,64,33758,33822,-1,24,33822,14120
18,78,33822,33900,1,165,33822,5929
18,78,33822,33900,-1,165,33900,14121
18,203,33900,34103,1,65,33900,5930
18,203,33900,34103,-1,65,34103,14122
18,119,34103,34222,1,63,34103,5931
18,119,34103,34222,-1,63,34222,14123
18,96,34222,34318,1,108,34222,5932
18,96,34222,34318,-1,108,34318,14124
18,132,34318,34450,1,163,34318,5933
18,132,34318,34450,-1,163,34450,14125
18,84,34450,34534,1,100,34450,5934
18,84,34450,34534,-1,100,34534,14126
18,40,34534,34574,1,91,34534,5935
18,40,34534,34574,-1,91,34574,14127
18,97,34574,34671,1,256,34574,5936
18,97,34574,34671,-1,256,34671,14128
18,72,34671,34743,1,183,34671,5937
18,72,34671,34743,-1,183,34743,14129
18,97,34743,34840,1,32,34743,5938
18,97,34743,34840,-1,32,34840,14130
18,87,34840,34927,1,86,34840,5939
18,87,34840,34927,-1,86,34927,14131
18,306,34927,35233,1,242,34927,5940
18,306,34927,35233,-1,242,35233,14132
18,85,35233,35318,1,71,35233,5941
18,85,35233,35318,-1,71,35318,14133
19,197,0,197,1,47,0,1535
19,197,0,197,-1,47,197,9727
19,235,197,432,1,15,197,1536
19,235,197,432,-1,15,432,9728
19,128,432,560,1,181,432,1537
19,128,432,560,-1,181,560,9729
19,161,560,721,1,168,560,1538
19,161,560,721,-1,168,721,9730
19,183,721,904,1,26,721,1539
19,183,721,904,-1,26,904,9731
19,125,904,1029,1,217,904,1540
19,125,904,1029,-1,217,1029,9732
19,79,1029,1108,1,190,1029,1541
19,79,1029,1108,-1,190,1108,9733
19,69,1108,1177,1,79,1108,1542
19,69,1108,1177,-1,79,1177,9734
19,52,1177,1229,1,90,1177,1543
19,52,1177,1229,-1,90,1229,9735
19,211,1229,1440,1,189,1229,1544
19,211,1229,1440,-1,189,1440,9736
19,69,1440,1509,1,119,1440,1545
19,69,1440,1509,-1,119,1509,9737
19,99,1509,1608,1,202,1509,1546
19,99,1509,1608,-1,202,1608,9738
19,133,1608,1741,1,128,1608,1547
19,133,1608,1741,-1,128,1741,9739
19,149,1741,1890,1,167,1741,1548
19,149,1741,1890,-1,167,1890,9740
19,227,1890,2117,1,34,1890,1549
19,227,1890,2117,-1,34,2117,9741
19,110,2117,2227,1,164,2117,1550
19,110,2117,2227,-1,164,2227,9742
19,67,2227,2294,1,205,2227,1551
19,67,2227,2294,-1,205,2294,9743
19,127,2294,2421,1,65,2294,1552
19,127,2294,2421,-1,65,2421,9744
19,133,2421,2554,1,210,2421,1553
19,133,2421,2554,-1,210,2554,9745
19,95,2554,2649,1,171,2554,1554
19,95,2554,2649,-1,171,2649,9746
19,117,2649,2766,1,186,2649,1555
19,117,2649,2766,-1,186,2766,9747
19,62,2766,2828,1,96,2766,1556
19,62,2766,2828,-1,96,2828,9748
19,195,2828,3023,1,118,2828,1557
19,195,2828,3023,-1,118,3023,9749
19,107,3023,3130,1,161,3023,1558
19,107,3023,3130,-1,161,3130,9750
19,157,3130,3287,1,19,3130,1559
19,157,3130,3287,-1,19,3287,9751
19,141,3287,3428,1,90,3287,1560
19,141,3287,3428,-1,90,3428,9752
19,181,3428,3609,1,141,3428,1561
19,181,3428,3609,-1,141,3609,9753
19,168,3609,3777,1,14,3609,1562
19,168,3609,3777,-1,14,3777,9754
19,118,3777,3895,1,142,3777,1563
19,118,3777,3895,-1,142,3895,9755
19,178,3895,4073,1,144,3895,1564
19,178,3895,4073,-1,144,4073,9756
19,372,4073,4445,1,109,4073,1565
19,372,4073,4445,-1,109,4445,9757
19,44,4445,4489,1,148,4445,1566
19,44,4445,4489,-1,148,4489,9758
19,119,4489,4608,1,238,4489,1567
19,119,4489,4608,-1,238,4608,9759
19,155,4608,4763,1,161,4608,1568
19,155,4608,4763,-1,161,4763,9760
19,82,4763,4845,1,59,4763,1569
19,82,4763,4845,-1,59,4845,9761
19,190,4845,5035,1,93,4845,1570
19,190,4845,5035,-1,93,5035,9762
19,60,5035,5095,1,11,5035,1571
19,60,5035,5095,-1,11,5095,9763
19,151,5095,5246,1,115,5095,1572
19,151,5095,5246,-1,115,5246,9764
19,86,5246,5332,1,49,5246,1573
19,86,5246,5332,-1,49,5332,9765
19,49,5332,5381,1,165,5332,1574
19,49,5332,5381,-1,165,5381,9766
19,173,5381,5554,1,233,5381,1575
19,173,5381,5554,-1,233,5554,9767
19,135,5554,5689,1,53,5554,1576
19,135,5554,5689,-1,53,5689,9768
19,37,5689,5726,1,222,5689,1577
19,37,5689,5726,-1,222,5726,9769
19,115,5726,5841,1,215,5726,1578
19,115,5726,5841,-1,215,5841,9770
19,33,5841,5874,1,235,5841,1579
19,33,5841,5874,-1,235,5874,9771
19,93,5874,5967,1,109,5874,1580
19,93,5874,5967,-1,109,5967,9772
19,62,5967,6029,1,229,5967,1581
19,62,5967,6029,-1,229,6029,9773
19,62,6029,6091,1,210,6029,1582
19,62,6029,6091,-1,210,6091,9774
19,70,6091,6161,1,232,6091,1583
19,70,6091,6161,-1,232,6161,9775
19,96,6161,6257,1,89,6161,1584
19,96,6161,6257,-1,89,6257,9776
19,116,6257,6373,1,68,6257,1585
19,116,6257,6373,-1,68,6373,9777
19,216,6373,6589,1,19,6373,1586
19,216,6373,6589,-1,19,6589,9778
19,70,6589,6659,1,121,6589,1587
19,70,6589,6659,-1,121,6659,9779
19,106,6659,6765,1,73,6659,1588
19,106,6659,6765,-1,73,6765,9780
19,105,6765,6870,1,69,6765,1589
19,105,6765,6870,-1,69,6870,9781
19,89,6870,6959,1,221,6870,1590
19,89,6870,6959,-1,221,6959,9782
19,78,6959,7037,1,238,6959,1591
19,78,6959,7037,-1,238,7037,9783
19,175,7037,7212,1,254,7037,1592
19,175,7037,7212,-1,254,7212,9784
19,126,7212,7338,1,34,7212,1593
19,126,7212,7338,-1,34,7338,9785
19,96,7338,7434,1,157,7338,1594
19,96,7338,7434,-1,157,7434,9786
19,59,7434,7493,1,24,7434,1595
19,59,7434,7493,-1,24,7493,9787
19,89,7493,7582,1,99,7493,1596
19,89,7493,7582,-1,99,7582,9788
19,68,7582,7650,1,73,7582,1597
19,68,7582,7650,-1,73,7650,9789
19,151,7650,7801,1,25,7650,1598
19,151,7650,7801,-1,25,7801,9790
19,94,7801,7895,1,72,7801,1599
19,94,7801,7895,-1,72,7895,9791
19,141,7895,8036,1,138,7895,1600
19,141,7895,8036,-1,138,8036,9792
19,266,8036,8302,1,165,8036,1601
19,266,8036,8302,-1,165,8302,9793
19,88,8302,8390,1,185,8302,1602
19,88,8302,8390,-1,185,8390,9794
19,159,8390,8549,1,35,8390,1603
19,159,8390,8549,-1,35,8549,9795
19,240,8549,8789,1,25,8549,1604
19,240,8549,8789,-1,25,8789,9796
19,123,8789,8912,1,187,8789,1605
19,123,8789,8912,-1,187,8912,9797
19,181,8912,9093,1,165,8912,1606
19,181,8912,9093,-1,165,9093,9798
19,212,9093,9305,1,36,9093,1607
19,212,9093,9305,-1,36,9305,9799
19,307,9305,9612,1,207,9305,1608
19,307,9305,9612,-1,207,9612,9800
19,124,9612,9736,1,247,9612,1609
19,124,9612,9736,-1,247,9736,9801
19,163,9736,9899,1,249,9736,1610
19,163,9736,9899,-1,249,9899,9802
19,85,9899,9984,1,37,9899,1611
19,85,9899,9984,-1,37,9984,9803
19,35,9984,10019,1,148,9984,1612
19,35,9984,10019,-1,148,10019,9804
19,50,10019,10069,1,150,10019,1613
19,50,10019,10069,-1,150,10069,9805
19,156,10069,10225,1,66,10069,1614
19,156,10069,10225,-1,66,10225,9806
19,51,10225,10276,1,145,10225,1615
19,51,10225,10276,-1,145,10276,9807
19,67,10276,10343,1,39,10276,1616
19,67,10276,10343,-1,39,10343,9808
19,115,10343,10458,1,131,10343,1617
19,115,10343,10458,-1,131,10458,9809
19,222,10458,10680,1,36,10458,1618
19,222,10458,10680,-1,36,10680,9810
19,129,10680,10809,1,18,10680,1619
19,129,10680,10809,-1,18,10809,9811
19,22,10809,10831,1,38,10809,1620
19,22,10809,10831,-1,38,10831,9812
19,218,10831,11049,1,193,10831,1621
19,218,10831,11049,-1,193,11049,9813
19,83,11049,11132,1,117,11049,1622
19,83,11049,11132,-1,117,11132,9814
19,67,11132,11199,1,71,11132,1623
19,67,11132,11199,-1,71,11199,9815
19,50,11199,11249,1,126,11199,1624
19,50,11199,11249,-1,126,11249,9816
19,321,11249,11570,1,176,11249,1625
19,321,11249,11570,-1,176,11570,9817
19,75,11570,11645,1,225,11570,1626
19,75,11570,11645,-1,225,11645,9818
19,103,11645,11748,1,139,11645,1627
19,103,11645,11748,-1,139,11748,9819
19,113,11748,11861,1,247,11748,1628
19,113,11748,11861,-1,247,11861,9820
19,150,11861,12011,1,127,11861,1629
19,150,11861,12011,-1,127,12011,9821
19,87,12011,12098,1,151,12011,1630
19,87,12011,12098,-1,151,12098,9822
19,316,12098,12414,1,201,12098,1631
19,316,12098,12414,-1,201,12414,9823
19,195,12414,12609,1,212,12414,1632
19,195,12414,12609,-1,212,12609,9824
19,169,12609,12778,1,115,12609,1633
19,169,12609,12778,-1,115,12778,9825
19,85,12778,12863,1,106,12778,1634
19,85,12778,12863,-1,106,12863,9826
19,131,12863,12994,1,39,12863,1635
19,131,12863,12994,-1,39,12994,9827
19,88,12994,13082,1,106,12994,1636
19,88,12994,13082,-1,106,13082,9828
19,80,13082,13162,1,38,13082,1637
19,80,13082,13162,-1,38,13162,9829
19,141,13162,13303,1,37,13162,1638
19,141,13162,13303,-1,37,13303,9830
19,147,13303,13450,1,112,13303,1639
19,147,13303,13450,-1,112,13450,9831
19,187,13450,13637,1,155,13450,1640
19,187,13450,13637,-1,155,13637,9832
19,77,13637,13714,1,78,13637,1641
19,77,13637,13714,-1,78,13714,9833
19,122,13714,13836,1,195,13714,1642
19,122,13714,13836,-1,195,13836,9834
19,104,13836,13940,1,229,13836,1643
19,104,13836,13940,-1,229,13940,9835
19,73,13940,14013,1,198,13940,1644
19,73,13940,14013,-1,198,14013,9836
19,73,14013,14086,1,125,14013,1645
19,73,14013,14086,-1,125,14086,9837
19,163,14086,14249,1,59,14086,1646
19,163,14086,14249,-1,59,14249,9838
19,165,14249,14414,1,140,14249,1647
19,165,14249,14414,-1,140,14414,9839
19,83,14414,14497,1,86,14414,1648
19,83,14414,14497,-1,86,14497,9840
19,264,14497,14761,1,200,14497,1649
19,264,14497,14761,-1,200,14761,9841
19,192,14761,14953,1,39,14761,1650
19,192,14761,14953,-1,39,14953,9842
19,37,14953,14990,1,18,14953,1651
19,37,14953,14990,-1,18,14990,9843
19,67,14990,15057,1,135,14990,1652
19,67,14990,15057,-1,135,15057,9844
19,300,15057,15357,1,213,15057,1653
19,300,15057,15357,-1,213,15357,9845
19,78,15357,15435,1,66,15357,1654
19,78,15357,15435,-1,66,15435,9846
19,183,15435,15618,1,256,15435,1655
19,183,15435,15618,-1,256,15618,9847
19,75,15618,15693,1,146,15618,1656
19,75,15618,15693,-1,146,15693,9848
19,120,15693,15813,1,9,15693,1657
19,120,15693,15813,-1,9,15813,9849
19,219,15813,16032,1,225,15813,1658
19,219,15813,16032,-1,225,16032,9850
19,127,16032,16159,1,99,16032,1659
19,127,16032,16159,-1,99,16159,9851
19,77,16159,16236,1,60,16159,1660
19,77,16159,16236,-1,60,16236,9852
19,59,16236,16295,1,94,16236,1661
19,59,16236,16295,-1,94,16295,9853
19,115,16295,16410,1,203,16295,1662
19,115,16295,16410,-1,203,16410,9854
19,192,16410,16602,1,36,16410,1663
19,192,16410,16602,-1,36,16602,9855
19,312,16602,16914,1,77,16602,1664
19,312,16602,16914,-1,77,16914,9856
19,63,16914,16977,1,3,16914,1665
19,63,16914,16977,-1,3,16977,9857
19,90,16977,17067,1,234,16977,1666
19,90,16977,17067,-1,234,17067,9858
19,123,17067,17190,1,116,17067,1667
19,123,17067,17190,-1,116,17190,9859
19,93,17190,17283,1,135,17190,1668
19,93,17190,17283,-1,135,17283,9860
19,274,17283,17557,1,28,17283,1669
19,274,17283,17557,-1,28,17557,9861
19,72,17557,17629,1,209,17557,1670
19,72,17557,17629,-1,209,17629,9862
19,152,17629,17781,1,131,17629,1671
19,152,17629,17781,-1,131,17781,9863
19,49,17781,17830,1,15,17781,1672
19,49,17781,17830,-1,15,17830,9864
19,137,17830,17967,1,51,17830,1673
19,137,17830,17967,-1,51,17967,9865
19,98,17967,18065,1,37,17967,1674
19,98,17967,18065,-1,37,18065,9866
19,103,18065,18168,1,24,18065,1675
19,103,18065,18168,-1,24,18168,9867
19,212,18168,18380,1,33,18168,1676
19,212,18168,18380,-1,33,18380,9868
19,117,18380,18497,1,243,18380,1677
19,117,18380,18497,-1,243,18497,9869
19,213,18497,18710,1,149,18497,1678
19,213,18497,18710,-1,149,18710,9870
19,60,18710,18770,1,189,18710,1679
19,60,18710,18770,-1,189,18770,9871
19,126,18770,18896,1,185,18770,1680
19,126,18770,18896,-1,185,18896,9872
19,114,18896,19010,1,206,18896,1681
19,114,18896,19010,-1,206,19010,9873
19,236,19010,19246,1,11,19010,1682
19,236,19010,19246,-1,11,19246,9874
19,150,19246,19396,1,97,19246,1683
19,150,19246,19396,-1,97,19396,9875
19,222,19396,19618,1,211,19396,1684
19,222,19396,19618,-1,211,19618,9876
19,213,19618,19831,1,97,19618,1685
19,213,19618,19831,-1,97,19831,9877
19,42,19831,19873,1,108,19831,1686
19,42,19831,19873,-1,108,19873,9878
19,184,19873,20057,1,100,19873,1687
19,184,19873,20057,-1,100,20057,9879
19,138,20057,20195,1,25,20057,1688
19,138,20057,20195,-1,25,20195,9880
19,159,20195,20354,1,27,20195,1689
19,159,20195,20354,-1,27,20354,9881
19,198,20354,20552,1,164,20354,1690
19,198,20354,20552,-1,164,20552,9882
19,74,20552,20626,1,231,20552,1691
19,74,20552,20626,-1,231,20626,9883
19,136,20626,20762,1,230,20626,1692
19,136,20626,20762,-1,230,20762,9884
19,132,20762,20894,1,203,20762,1693
19,132,20762,20894,-1,203,20894,9885
19,122,20894,21016,1,183,20894,1694
19,122,20894,21016,-1,183,21016,9886
19,122,21016,21138,1,91,21016,1695
19,122,21016,21138,-1,91,21138,9887
19,121,21138,21259,1,181,21138,1696
19,121,21138,21259,-1,181,21259,9888
19,55,21259,21314,1,73,21259,1697
19,55,21259,21314,-1,73,21314,9889
19,176,21314,21490,1,46,21314,1698
19,176,21314,21490,-1,46,21490,9890
19,172,21490,21662,1,88,21490,1699
19,172,21490,21662,-1,88,21662,9891
19,41,21662,21703,1,135,21662,1700
19,41,21662,21703,-1,135,21703,9892
19,65,21703,21768,1,48,21703,1701
19,65,21703,21768,-1,48,21768,9893
19,113,21768,21881,1,72,21768,1702
19,113,21768,21881,-1,72,21881,9894
19,268,21881,22149,1,69,21881,1703
19,268,21881,22149,-1,69,22149,9895
19,208,22149,22357,1,159,22149,1704
19,208,22149,22357,-1,159,22357,9896
19,106,22357,22463,1,18,22357,1705
19,106,22357,22463,-1,18,22463,9897
19,59,22463,22522,1,27,22463,1706
19,59,22463,22522,-1,27,22522,9898
19,60,22522,22582,1,195,22522,1707
19,60,22522,22582,-1,195,22582,9899
19,68,22582,22650,1,41,22582,1708
19,68,22582,22650,-1,41,22650,9900
19,98,22650,22748,1,99,22650,1709
19,98,22650,22748,-1,99,22748,9901
19,42,22748,22790,1,238,22748,1710
19,42,22748,22790,-1,238,22790,9902
19,162,22790,22952,1,88,22790,1711
19,162,22790,22952,-1,88,22952,9903
19,190,22952,23142,1,51,22952,1712
19,190,22952,23142,-1,51,23142,9904
19,180,23142,23322,1,250,23142,1713
19,180,23142,23322,-1,250,23322,9905
19,16,23322,23338,1,161,23322,1714
19,16,23322,23338,-1,161,23338,9906
19,188,23338,23526,1,35,23338,1715
19,188,23338,23526,-1,35,23526,9907
19,103,23526,23629,1,195,23526,1716
19,103,23526,23629,-1,195,23629,9908
19,210,23629,23839,1,149,23629,1717
19,210,23629,23839,-1,149,23839,9909
19,66,23839,23905,1,166,23839,1718
19,66,23839,23905,-1,166,23905,9910
19,69,23905,23974,1,115,23905,1719
19,69,23905,23974,-1,115,23974,9911
19,39,23974,24013,1,39,23974,1720
19,39,23974,24013,-1,39,24013,9912
19,227,24013,24240,1,111,24013,1721
19,227,24013,24240,-1,111,24240,9913
19,75,24240,24315,1,205,24240,1722
19,75,24240,24315,-1,205,24315,9914
19,60,24315,24375,1,30,24315,1723
19,60,24315,24375,-1,30,24375,9915
19,128,24375,24503,1,45,24375,1724
19,128,24375,24503,-1,45,24503,9916
19,251,24503,24754,1,197,24503,1725
19,251,24503,24754,-1,197,24754,9917
19,111,24754,24865,1,160,24754,1726
19,111,24754,24865,-1,160,24865,9918
19,79,24865,24944,1,53,24865,1727
19,79,24865,24944,-1,53,24944,9919
19,157,24944,25101,1,210,24944,1728
19,157,24944,25101,-1,210,25101,9920
19,24,25101,25125,1,195,25101,1729
19,24,25101,25125,-1,195,25125,9921
19,88,25125,25213,1,2,25125,1730
19,88,25125,25213,-1,2,25213,9922
19,117,25213,25330,1,221,25213,1731
19,117,25213,25330,-1,221,25330,9923
19,170,25330,25500,1,40,25330,1732
19,170,25330,25500,-1,40,25500,9924
19,152,25500,25652,1,23,25500,1733
19,152,25500,25652,-1,23,25652,9925
19,96,25652,25748,1,51,25652,1734
19,96,25652,25748,-1,51,25748,9926
19,89,25748,25837,1,229,25748,1735
19,89,25748,25837,-1,229,25837,9927
19,39,25837,25876,1,17,25837,1736
19,39,25837,25876,-1,17,25876,9928
19,170,25876,26046,1,144,25876,1737
19,170,25876,26046,-1,144,26046,9929
19,85,26046,26131,1,60,26046,1738
19,85,26046,26131,-1,60,26131,9930
19,57,26131,26188,1,245,26131,1739
19,57,26131,26188,-1,245,26188,9931
19,104,26188,26292,1,249,26188,1740
19,104,26188,26292,-1,249,26292,9932
19,90,26292,26382,1,65,26292,1741
19,90,26292,26382,-1,65,26382,9933
19,165,26382,26547,1,235,26382,1742
19,165,26382,26547,-1,235,26547,9934
19,207,26547,26754,1,229,26547,1743
19,207,26547,26754,-1,229,26754,9935
19,121,26754,26875,1,114,26754,1744
19,121,26754,26875,-1,114,26875,9936
19,108,26875,26983,1,112,26875,1745
19,108,26875,26983,-1,112,26983,9937
19,80,26983,27063,1,109,26983,1746
19,80,26983,27063,-1,109,27063,9938
19,95,27063,27158,1,70,27063,1747
19,95,27063,27158,-1,70,27158,9939
19,75,27158,27233,1,19,27158,1748
19,75,27158,27233,-1,19,27233,9940
19,106,27233,27339,1,14,27233,1749
19,106,27233,27339,-1,14,27339,9941
19,184,27339,27523,1,187,27339,1750
19,184,27339,27523,-1,187,27523,9942
19,89,27523,27612,1,5,27523,1751
19,89,27523,27612,-1,5,27612,9943
19,103,27612,27715,1,99,27612,1752
19,103,27612,27715,-1,99,27715,9944
19,82,27715,27797,1,28,27715,1753
19,82,27715,27797,-1,28,27797,9945
19,137,27797,27934,1,187,27797,1754
19,137,27797,27934,-1,187,27934,9946
19,147,27934,28081,1,74,27934,1755
19,147,27934,28081,-1,74,28081,9947
19,151,28081,28232,1,77,28081,1756
19,151,28081,28232,-1,77,28232,9948
19,64,28232,28296,1,213,28232,1757
19,64,28232,28296,-1,213,28296,9949
19,131,28296,28427,1,10,28296,1758
19,131,28296,28427,-1,10,28427,9950
19,27,28427,28454,1,166,28427,1759
19,27,28427,28454,-1,166,28454,9951
19,99,28454,28553,1,115,28454,1760
19,99,28454,28553,-1,115,28553,9952
19,146,28553,28699,1,92,28553,1761
19,146,28553,28699,-1,92,28699,9953
19,110,28699,28809,1,186,28699,1762
19,110,28699,28809,-1,186,28809,9954
19,127,28809,28936,1,26,28809,1763
19,127,28809,28936,-1,26,28936,9955
19,46,28936,28982,1,170,28936,1764
19,46,28936,28982,-1,170,28982,9956
19,135,28982,29117,1,113,28982,1765
19,135,28982,29117,-1,113,29117,9957
19,35,29117,29152,1,222,29117,1766
19,35,29117,29152,-1,222,29152,9958
19,198,29152,29350,1,61,29152,1767
19,198,29152,29350,-1,61,29350,9959
19,85,29350,29435,1,68,29350,1768
19,85,29350,29435,-1,68,29435,9960
19,92,29435,29527,1,29,29435,1769
19,92,29435,29527,-1,29,29527,9961
19,130,29527,29657,1,192,29527,1770
19,130,29527,29657,-1,192,29657,9962
19,140,29657,29797,1,30,29657,1771
19,140,29657,29797,-1,30,29797,9963
19,288,29797,30085,1,225,29797,1772
19,288,29797,30085,-1,225,30085,9964
19,121,30085,30206,1,185,30085,1773
19,121,30085,30206,-1,185,30206,9965
19,53,30206,30259,1,27,30206,1774
19,53,30206,30259,-1,27,30259,9966
19,111,30259,30370,1,108,30259,1775
19,111,30259,30370,-1,108,30370,9967
19,175,30370,30545,1,240,30370,1776
19,175,30370,30545,-1,240,30545,9968
19,188,30545,30733,1,2,30545,1777
19,188,30545,30733,-1,2,30733,9969
19,52,30733,30785,1,94,30733,1778
19,52,30733,30785,-1,94,30785,9970
19,213,30785,30998,1,232,30785,1779
19,213,30785,30998,-1,232,30998,9971
19,100,30998,31098,1,169,30998,1780
19,100,30998,31098,-1,169,31098,9972
19,58,31098,31156,1,94,31098,1781
19,58,31098,31156,-1,94,31156,9973
19,63,31156,31219,1,30,31156,1782
19,63,31156,31219,-1,30,31219,9974
19,107,31219,31326,1,138,31219,1783
19,107,31219,31326,-1,138,31326,9975
19,173,31326,31499,1,110,31326,1784
19,173,31326,31499,-1,110,31499,9976
19,131,31499,31630,1,55,31499,1785
19,131,31499,31630,-1,55,31630,9977
19,86,31630,31716,1,192,31630,1786
19,86,31630,31716,-1,192,31716,9978
19,154,31716,31870,1,163,31716,1787
19,154,31716,31870,-1,163,31870,9979
19,164,31870,32034,1,149,31870,1788
19,164,31870,32034,-1,149,32034,9980
19,75,32034,32109,1,46,32034,1789
19,75,32034,32109,-1,46,32109,9981
19,127,32109,32236,1,63,32109,1790
19,127,32109,32236,-1,63,32236,9982
19,71,32236,32307,1,165,32236,1791
19,71,32236,32307,-1,165,32307,9983
19,167,32307,32474,1,89,32307,1792
19,167,32307,32474,-1,89,32474,9984
19,99,32474,32573,1,212,32474,1793
19,99,32474,32573,-1,212,32573,9985
19,226,32573,32799,1,156,32573,1794
19,226,32573,32799,-1,156,32799,9986
19,130,32799,32929,1,2,32799,1795
19,130,32799,32929,-1,2,32929,9987
19,113,32929,33042,1,221,32929,1796
19,113,32929,33042,-1,221,33042,9988
19,115,33042,33157,1,192,33042,1797
19,115,33042,33157,-1,192,33157,9989
19,67,33157,33224,1,209,33157,1798
19,67,33157,33224,-1,209,33224,9990
19,163,33224,33387,1,45,33224,1799
19,163,33224,33387,-1,45,33387,9991
19,186,33387,33573,1,134,33387,1800
19,186,33387,33573,-1,134,33573,9992
19,43,33573,33616,1,95,33573,1801
19,43,33573,33616,-1,95,33616,9993
19,86,33616,33702,1,66,33616,1802
19,86,33616,33702,-1,66,33702,9994
19,90,33702,33792,1,18,33702,1803
19,90,33702,33792,-1,18,33792,9995
19,179,33792,33971,1,135,33792,1804
19,179,33792,33971,-1,135,33971,9996
19,88,33971,34059,1,200,33971,1805
19,88,33971,34059,-1,200,34059,9997
19,128,34059,34187,1,115,34059,1806
19,128,34059,34187,-1,115,34187,9998
19,370,34187,34557,1,57,34187,1807
19,370,34187,34557,-1,57,34557,9999
19,140,34557,34697,1,47,34557,1808
19,140,34557,34697,-1,47,34697,10000
19,86,34697,34783,1,25,34697,1809
19,86,34697,34783,-1,25,34783,10001
19,72,34783,34855,1,186,34783,1810
19,72,34783,34855,-1,186,34855,10002
20,114,0,114,1,2,0,7965
20,114,0,114,-1,2,114,16157
20,144,114,258,1,34,114,7966
20,144,114,258,-1,34,258,16158
20,208,258,466,1,126,258,7967
20,208,258,466,-1,126,466,16159
20,78,466,544,1,93,466,7968
20,78,466,544,-1,93,544,16160
20,181,544,725,1,106,544,7969
20,181,544,725,-1,106,725,16161
20,158,725,883,1,81,725,7970
20,158,725,883,-1,81,883,16162
20,147,883,1030,1,229,883,7971
20,147,883,1030,-1,229,1030,16163
20,83,1030,1113,1,76,1030,7972
20,83,1030,1113,-1,76,1113,16164
20,116,1113,1229,1,4,1113,7973
20,116,1113,1229,-1,4,1229,16165
20,146,1229,1375,1,105,1229,7974
20,146,1229,1375,-1,105,1375,16166
20,187,1375,1562,1,46,1375,7975
20,187,1375,1562,-1,46,1562,16167
20,123,1562,1685,1,68,1562,7976
20,123,1562,1685,-1,68,1685,16168
20,176,1685,1861,1,1,1685,7977
20,176,1685,1861,-1,1,1861,16169
20,110,1861,1971,1,204,1861,7978
20,110,1861,1971,-1,204,1971,16170
20,94,1971,2065,1,40,1971,7979
20,94,1971,2065,-1,40,2065,16171
20,172,2065,2237,1,26,2065,7980
20,172,2065,2237,-1,26,2237,16172
20,82,2237,2319,1,43,2237,7981
20,82,2237,2319,-1,43,2319,16173
20,239,2319,2558,1,2,2319,7982
20,239,2319,2558,-1,2,2558,16174
20,83,2558,2641,1,6,2558,7983
20,83,2558,2641,-1,6,2641,16175
20,145,2641,2786,1,132,2641,7984
20,145,2641,2786,-1,132,2786,16176
20,61,2786,2847,1,3,2786,7985
20,61,2786,2847,-1,3,2847,16177
20,80,2847,2927,1,95,2847,7986
20,80,2847,2927,-1,95,2927,16178
20,98,2927,3025,1,213,2927,7987
20,98,2927,3025,-1,213,3025,16179
20,166,3025,3191,1,84,3025,7988
20,166,3025,3191,-1,84,3191,16180
20,82,3191,3273,1,92,3191,7989
20,82,3191,3273,-1,92,3273,16181
20,73,3273,3346,1,52,3273,7990
20,73,3273,3346,-1,52,3346,16182
20,63,3346,3409,1,185,3346,7991
20,63,3346,3409,-1,185,3409,16183
20,74,3409,3483,1,181,3409,7992
20,74,3409,3483,-1,181,3483,16184
20,148,3483,3631,1,29,3483,7993
20,148,3483,3631,-1,29,3631,16185
20,100,3631,3731,1,27,3631,7994
20,100,3631,3731,-1,27,3731,16186
20,147,3731,3878,1,61,3731,7995
20,147,3731,3878,-1,61,3878,16187
20,80,3878,3958,1,132,3878,7996
20,80,3878,3958,-1,132,3958,16188
20,204,3958,4162,1,132,3958,7997
20,204,3958,4162,-1,132,4162,16189
20,24,4162,4186,1,180,4162,7998
20,24,4162,4186,-1,180,4186,16190
20,113,4186,4299,1,206,4186,7999
20,113,4186,4299,-1,206,4299,16191
20,80,4299,4379,1,120,4299,8000
20,80,4299,4379,-1,120,4379,16192
20,73,4379,4452,1,93,4379,8001
20,73,4379,4452,-1,93,4452,16193
20,66,4452,4518,1,165,4452,8002
20,66,4452,4518,-1,165,4518,16194
20,106,4518,4624,1,125,4518,8003
20,106,4518,4624,-1,125,4624,16195
20,89,4624,4713,1,246,4624,8004
20,89,4624,4713,-1,246,4713,16196
20,99,4713,4812,1,82,4713,8005
20,99,4713,4812,-1,82,4812,16197
20,226,4812,5038,1,251,4812,8006
20,226,4812,5038,-1,251,5038,16198
20,49,5038,5087,1,191,5038,8007
20,49,5038,5087,-1,191,5087,16199
20,136,5087,5223,1,103,5087,8008
20,136,5087,5223,-1,103,5223,16200
20,151,5223,5374,1,151,5223,8009
20,151,5223,5374,-1,151,5374,16201
20,74,5374,5448,1,148,5374,8010
20,74,5374,5448,-1,148,5448,16202
20,85,5448,5533,1,94,5448,8011
20,85,5448,5533,-1,94,5533,16203
20,103,5533,5636,1,24,5533,8012
20,103,5533,5636,-1,24,5636,16204
20,39,5636,5675,1,187,5636,8013
20,39,5636,5675,-1,187,5675,16205
20,131,5675,5806,1,241,5675,8014
20,131,5675,5806,-1,241,5806,16206
20,82,5806,5888,1,162,5806,8015
20,82,5806,5888,-1,162,5888,16207
20,52,5888,5940,1,122,5888,8016
20,52,5888,5940,-1,122,5940,16208
20,78,5940,6018,1,199,5940,8017
20,78,5940,6018,-1,199,6018,16209
20,185,6018,6203,1,255,6018,8018
20,185,6018,6203,-1,255,6203,16210
20,130,6203,6333,1,25,6203,8019
20,130,6203,6333,-1,25,6333,16211
20,224,6333,6557,1,253,6333,8020
20,224,6333,6557,-1,253,6557,16212
20,146,6557,6703,1,26,6557,8021
20,146,6557,6703,-1,26,6703,16213
20,104,6703,6807,1,213,6703,8022
20,104,6703,6807,-1,213,6807,16214
20,86,6807,6893,1,66,6807,8023
20,86,6807,6893,-1,66,6893,16215
20,144,6893,7037,1,42,6893,8024
20,144,6893,7037,-1,42,7037,16216
20,71,7037,7108,1,241,7037,8025
20,71,7037,7108,-1,241,7108,16217
20,88,7108,7196,1,180,7108,8026
20,88,7108,7196,-1,180,7196,16218
20,185,7196,7381,1,223,7196,8027
20,185,7196,7381,-1,223,7381,16219
20,210,7381,7591,1,97,7381,8028
20,210,7381,7591,-1,97,7591,16220
20,136,7591,7727,1,80,7591,8029
20,136,7591,7727,-1,80,7727,16221
20,140,7727,7867,1,115,7727,8030
20,140,7727,7867,-1,115,7867,16222
20,131,7867,7998,1,18,7867,8031
20,131,7867,7998,-1,18,7998,16223
20,41,7998,8039,1,233,7998,8032
20,41,7998,8039,-1,233,8039,16224
20,205,8039,8244,1,11,8039,8033
20,205,8039,8244,-1,11,8244,16225
20,62,8244,8306,1,20,8244,8034
20,62,8244,8306,-1,20,8306,16226
20,98,8306,8404,1,171,8306,8035
20,98,8306,8404,-1,171,8404,16227
20,164,8404,8568,1,143,8404,8036
20,164,8404,8568,-1,143,8568,16228
20,134,8568,8702,1,152,8568,8037
20,134,8568,8702,-1,152,8702,16229
20,114,8702,8816,1,181,8702,8038
20,114,8702,8816,-1,181,8816,16230
20,118,8816,8934,1,3,8816,8039
20,118,8816,8934,-1,3,8934,16231
20,184,8934,9118,1,86,8934,8040
20,184,8934,9118,-1,86,9118,16232
20,165,9118,9283,1,28,9118,8041
20,165,9118,9283,-1,28,9283,16233
20,84,9283,9367,1,241,9283,8042
20,84,9283,9367,-1,241,9367,16234
20,60,9367,9427,1,136,9367,8043
20,60,9367,9427,-1,136,9427,16235
20,149,9427,9576,1,1,9427,8044
20,149,9427,9576,-1,1,9576,16236
20,237,9576,9813,1,117,9576,8045
20,237,9576,9813,-1,117,9813,16237
20,174,9813,9987,1,60,9813,8046
20,174,9813,9987,-1,60,9987,16238
20,50,9987,10037,1,147,9987,8047
20,50,9987,10037,-1,147,10037,16239
20,73,10037,10110,1,118,10037,8048
20,73,10037,10110,-1,118,10110,16240
20,145,10110,10255,1,141,10110,8049
20,145,10110,10255,-1,141,10255,16241
20,122,10255,10377,1,33,10255,8050
20,122,10255,10377,-1,33,10377,16242
20,171,10377,10548,1,167,10377,8051
20,171,10377,10548,-1,167,10548,16243
20,106,10548,10654,1,81,10548,8052
20,106,10548,10654,-1,81,10654,16244
20,159,10654,10813,1,247,10654,8053
20,159,10654,10813,-1,247,10813,16245
20,60,10813,10873,1,239,10813,8054
20,60,10813,10873,-1,239,10873,16246
20,126,10873,10999,1,204,10873,8055
20,126,10873,10999,-1,204,10999,16247
20,67,10999,11066,1,218,10999,8056
20,67,10999,11066,-1,218,11066,16248
20,40,11066,11106,1,184,11066,8057
20,40,11066,11106,-1,184,11106,16249
20,175,11106,11281,1,91,11106,8058
20,175,11106,11281,-1,91,11281,16250
20,63,11281,11344,1,209,11281,8059
20,63,11281,11344,-1,209,11344,16251
20,71,11344,11415,1,28,11344,8060
20,71,11344,11415,-1,28,11415,16252
20,58,11415,11473,1,139,11415,8061
20,58,11415,11473,-1,139,11473,16253
20,256,11473,11729,1,155,11473,8062
20,256,11473,11729,-1,155,11729,16254
20,68,11729,11797,1,140,11729,8063
20,68,11729,11797,-1,140,11797,16255
20,168,11797,11965,1,31,11797,8064
20,168,11797,11965,-1,31,11965,16256
20,90,11965,12055,1,189,11965,8065
20,90,11965,12055,-1,189,12055,16257
20,49,12055,12104,1,231,12055,8066
20,49,12055,12104,-1,231,12104,16258
20,78,12104,12182,1,68,12104,8067
20,78,12104,12182,-1,68,12182,16259
20,123,12182,12305,1,203,12182,8068
20,123,12182,12305,-1,203,12305,16260
20,159,12305,12464,1,52,12305,8069
20,159,12305,12464,-1,52,12464,16261
20,82,12464,12546,1,242,12464,8070
20,82,12464,12546,-1,242,12546,16262
20,92,12546,12638,1,161,12546,8071
20,92,12546,12638,-1,161,12638,16263
20,58,12638,12696,1,95,12638,8072
20,58,12638,12696,-1,95,12696,16264
20,166,12696,12862,1,247,12696,8073
20,166,12696,12862,-1,247,12862,16265
20,108,12862,12970,1,60,12862,8074
20,108,12862,12970,-1,60,12970,16266
20,69,12970,13039,1,19,12970,8075
20,69,12970,13039,-1,19,13039,16267
20,63,13039,13102,1,73,13039,8076
20,63,13039,13102,-1,73,13102,16268
20,243,13102,13345,1,105,13102,8077
20,243,13102,13345,-1,105,13345,16269
20,211,13345,13556,1,50,13345,8078
20,211,13345,13556,-1,50,13556,16270
20,79,13556,13635,1,189,13556,8079
20,79,13556,13635,-1,189,13635,16271
20,159,13635,13794,1,64,13635,8080
20,159,13635,13794,-1,64,13794,16272
20,61,13794,13855,1,162,13794,8081
20,61,13794,13855,-1,162,13855,16273
20,89,13855,13944,1,205,13855,8082
20,89,13855,13944,-1,205,13944,16274
20,179,13944,14123,1,54,13944,8083
20,179,13944,14123,-1,54,14123,16275
20,106,14123,14229,1,110,14123,8084
20,106,14123,14229,-1,110,14229,16276
20,81,14229,14310,1,135,14229,8085
20,81,14229,14310,-1,135,14310,16277
20,127,14310,14437,1,64,14310,8086
20,127,14310,14437,-1,64,14437,16278
20,95,14437,14532,1,201,14437,8087
20,95,14437,14532,-1,201,14532,16279
20,166,14532,14698,1,65,14532,8088
20,166,14532,14698,-1,65,14698,16280
20,155,14698,14853,1,107,14698,8089
20,155,14698,14853,-1,107,14853,16281
20,107,14853,14960,1,208,14853,8090
20,107,14853,14960,-1,208,14960,16282
20,206,14960,15166,1,9,14960,8091
20,206,14960,15166,-1,9,15166,16283
20,214,15166,15380,1,116,15166,8092
20,214,15166,15380,-1,116,15380,16284
20,95,15380,15475,1,99,15380,8093
20,95,15380,15475,-1,99,15475,16285
20,137,15475,15612,1,66,15475,8094
20,137,15475,15612,-1,66,15612,16286
20,119,15612,15731,1,165,15612,8095
20,119,15612,15731,-1,165,15731,16287
20,84,15731,15815,1,50,15731,8096
20,84,15731,15815,-1,50,15815,16288
20,82,15815,15897,1,96,15815,8097
20,82,15815,15897,-1,96,15897,16289
20,215,15897,16112,1,192,15897,8098
20,215,15897,16112,-1,192,16112,16290
20,235,16112,16347,1,212,16112,8099
20,235,16112,16347,-1,212,16347,16291
20,151,16347,16498,1,192,16347,8100
20,151,16347,16498,-1,192,16498,16292
20,294,16498,16792,1,191,16498,8101
20,294,16498,16792,-1,191,16792,16293
20,221,16792,17013,1,197,16792,8102
20,221,16792,17013,-1,197,17013,16294
20,189,17013,17202,1,15,17013,8103
20,189,17013,17202,-1,15,17202,16295
20,180,17202,17382,1,253,17202,8104
20,180,17202,17382,-1,253,17382,16296
20,156,17382,17538,1,207,17382,8105
20,156,17382,17538,-1,207,17538,16297
20,28,17538,17566,1,24,17538,8106
20,28,17538,17566,-1,24,17566,16298
20,79,17566,17645,1,123,17566,8107
20,79,17566,17645,-1,123,17645,16299
20,170,17645,17815,1,107,17645,8108
20,170,17645,17815,-1,107,17815,16300
20,207,17815,18022,1,226,17815,8109
20,207,17815,18022,-1,226,18022,16301
20,92,18022,18114,1,124,18022,8110
20,92,18022,18114,-1,124,18114,16302
20,35,18114,18149,1,126,18114,8111
20,35,18114,18149,-1,126,18149,16303
20,182,18149,18331,1,161,18149,8112
20,182,18149,18331,-1,161,18331,16304
20,71,18331,18402,1,36,18331,8113
20,71,18331,18402,-1,36,18402,16305
20,108,18402,18510,1,67,18402,8114
20,108,18402,18510,-1,67,18510,16306
20,47,18510,18557,1,89,18510,8115
20,47,18510,18557,-1,89,18557,16307
20,167,18557,18724,1,25,18557,8116
20,167,18557,18724,-1,25,18724,16308
20,37,18724,18761,1,170,18724,8117
20,37,18724,18761,-1,170,18761,16309
20,454,18761,19215,1,254,18761,8118
20,454,18761,19215,-1,254,19215,16310
20,174,19215,19389,1,185,19215,8119
20,174,19215,19389,-1,185,19389,16311
20,200,19389,19589,1,112,19389,8120
20,200,19389,19589,-1,112,19589,16312
20,88,19589,19677,1,89,19589,8121
20,88,19589,19677,-1,89,19677,16313
20,103,19677,19780,1,40,19677,8122
20,103,19677,19780,-1,40,19780,16314
20,88,19780,19868,1,30,19780,8123
20,88,19780,19868,-1,30,19868,16315
20,128,19868,19996,1,189,19868,8124
20,128,19868,19996,-1,189,19996,16316
20,19,19996,20015,1,178,19996,8125
20,19,19996,20015,-1,178,20015,16317
20,108,20015,20123,1,108,20015,8126
20,108,20015,20123,-1,108,20123,16318
20,87,20123,20210,1,42,20123,8127
20,87,20123,20210,-1,42,20210,16319
20,107,20210,20317,1,93,20210,8128
20,107,20210,20317,-1,93,20317,16320
20,89,20317,20406,1,245,20317,8129
20,89,20317,20406,-1,245,20406,16321
20,141,20406,20547,1,100,20406,8130
20,141,20406,20547,-1,100,20547,16322
20,199,20547,20746,1,139,20547,8131
20,199,20547,20746,-1,139,20746,16323
20,62,20746,20808,1,162,20746,8132
20,62,20746,20808,-1,162,20808,16324
20,119,20808,20927,1,176,20808,8133
20,119,20808,20927,-1,176,20927,16325
20,228,20927,21155,1,196,20927,8134
20,228,20927,21155,-1,196,21155,16326
20,160,21155,21315,1,146,21155,8135
20,160,21155,21315,-1,146,21315,16327
20,176,21315,21491,1,87,21315,8136
20,176,21315,21491,-1,87,21491,16328
20,75,21491,21566,1,231,21491,8137
20,75,21491,21566,-1,231,21566,16329
20,162,21566,21728,1,107,21566,8138
20,162,21566,21728,-1,107,21728,16330
20,102,21728,21830,1,94,21728,8139
20,102,21728,21830,-1,94,21830,16331
20,140,21830,21970,1,165,21830,8140
20,140,21830,21970,-1,165,21970,16332
20,201,21970,22171,1,63,21970,8141
20,201,21970,22171,-1,63,22171,16333
20,106,22171,22277,1,188,22171,8142
20,106,22171,22277,-1,188,22277,16334
20,91,22277,22368,1,206,22277,8143
20,91,22277,22368,-1,206,22368,16335
20,102,22368,22470,1,236,22368,8144
20,102,22368,22470,-1,236,22470,16336
20,91,22470,22561,1,93,22470,8145
20,91,22470,22561,-1,93,22561,16337
20,93,22561,22654,1,67,22561,8146
20,93,22561,22654,-1,67,22654,16338
20,75,22654,22729,1,240,22654,8147
20,75,22654,22729,-1,240,22729,16339
20,76,22729,22805,1,24,22729,8148
20,76,22729,22805,-1,24,22805,16340
20,93,22805,22898,1,117,22805,8149
20,93,22805,22898,-1,117,22898,16341
20,110,22898,23008,1,29,22898,8150
20,110,22898,23008,-1,29,23008,16342
20,37,23008,23045,1,139,23008,8151
20,37,23008,23045,-1,139,23045,16343
20,53,23045,23098,1,142,23045,8152
20,53,23045,23098,-1,142,23098,16344
20,170,23098,23268,1,106,23098,8153
20,170,23098,23268,-1,106,23268,16345
20,165,23268,23433,1,163,23268,8154
20,165,23268,23433,-1,163,23433,16346
20,132,23433,23565,1,203,23433,8155
20,132,23433,23565,-1,203,23565,16347
20,83,23565,23648,1,231,23565,8156
20,83,23565,23648,-1,231,23648,16348
20,58,23648,23706,1,47,23648,8157
20,58,23648,23706,-1,47,23706,16349
20,106,23706,23812,1,84,23706,8158
20,106,23706,23812,-1,84,23812,16350
20,48,23812,23860,1,221,23812,8159
20,48,23812,23860,-1,221,23860,16351
20,80,23860,23940,1,25,23860,8160
20,80,23860,23940,-1,25,23940,16352
20,48,23940,23988,1,224,23940,8161
20,48,23940,23988,-1,224,23988,16353
20,166,23988,24154,1,221,23988,8162
20,166,23988,24154,-1,221,24154,16354
20,51,24154,24205,1,237,24154,8163
20,51,24154,24205,-1,237,24205,16355
20,73,24205,24278,1,218,24205,8164
20,73,24205,24278,-1,218,24278,16356
20,123,24278,24401,1,185,24278,8165
20,123,24278,24401,-1,185,24401,16357
20,119,24401,24520,1,42,24401,8166
20,119,24401,24520,-1,42,24520,16358
20,45,24520,24565,1,78,24520,8167
20,45,24520,24565,-1,78,24565,16359
20,175,24565,24740,1,195,24565,8168
20,175,24565,24740,-1,195,24740,16360
20,151,24740,24891,1,179,24740,8169
20,151,24740,24891,-1,179,24891,16361
20,95,24891,24986,1,190,24891,8170
20,95,24891,24986,-1,190,24986,16362
20,94,24986,25080,1,37,24986,8171
20,94,24986,25080,-1,37,25080,16363
20,50,25080,25130,1,207,25080,8172
20,50,25080,25130,-1,207,25130,16364
20,182,25130,25312,1,30,25130,8173
20,182,25130,25312,-1,30,25312,16365
20,107,25312,25419,1,46,25312,8174
20,107,25312,25419,-1,46,25419,16366
20,149,25419,25568,1,164,25419,8175
20,149,25419,25568,-1,164,25568,16367
20,75,25568,25643,1,199,25568,8176
20,75,25568,25643,-1,199,25643,16368
20,32,25643,25675,1,232,25643,8177
20,32,25643,25675,-1,232,25675,16369
20,198,25675,25873,1,106,25675,8178
20,198,25675,25873,-1,106,25873,16370
20,125,25873,25998,1,139,25873,8179
20,125,25873,25998,-1,139,25998,16371
20,126,25998,26124,1,146,25998,8180
20,126,25998,26124,-1,146,26124,16372
20,63,26124,26187,1,151,26124,8181
20,63,26124,26187,-1,151,26187,16373
20,146,26187,26333,1,212,26187,8182
20,146,26187,26333,-1,212,26333,16374
20,140,26333,26473,1,71,26333,8183
20,140,26333,26473,-1,71,26473,16375
20,116,26473,26589,1,149,26473,8184
20,116,26473,26589,-1,149,26589,16376
20,101,26589,26690,1,156,26589,8185
20,101,26589,26690,-1,156,26690,16377
20,88,26690,26778,1,130,26690,8186
20,88,26690,26778,-1,130,26778,16378
20,49,26778,26827,1,155,26778,8187
20,49,26778,26827,-1,155,26827,16379
20,67,26827,26894,1,106,26827,8188
20,67,26827,26894,-1,106,26894,16380
20,156,26894,27050,1,196,26894,8189
20,156,26894,27050,-1,196,27050,16381
20,116,27050,27166,1,129,27050,8190
20,116,27050,27166,-1,129,27166,16382
20,146,27166,27312,1,70,27166,8191
20,146,27166,27312,-1,70,27312,16383
20,115,27312,27427,1,155,27312,8192
20,115,27312,27427,-1,155,27427,16384
21,72,0,72,1,255,0,4405
21,72,0,72,-1,255,72,12597
21,71,72,143,1,70,72,4406
21,71,72,143,-1,70,143,12598
21,4,143,147,1,58,143,4407
21,4,143,147,-1,58,147,12599
21,196,147,343,1,63,147,4408
21,196,147,343,-1,63,343,12600
21,150,343,493,1,17,343,4409
21,150,343,493,-1,17,493,12601
21,72,493,565,1,8,493,4410
21,72,493,565,-1,8,565,12602
21,146,565,711,1,114,565,4411
21,146,565,711,-1,114,711,12603
21,307,711,1018,1,94,711,4412
21,307,711,1018,-1,94,1018,12604
21,240,1018,1258,1,67,1018,4413
21,240,1018,1258,-1,67,1258,12605
21,82,1258,1340,1,155,1258,4414
21,82,1258,1340,-1,155,1340,12606
21,73,1340,1413,1,190,1340,4415
21,73,1340,1413,-1,190,1413,12607
21,169,1413,1582,1,63,1413,4416
21,169,1413,1582,-1,63,1582,12608
21,45,1582,1627,1,125,1582,4417
21,45,1582,1627,-1,125,1627,12609
21,122,1627,1749,1,211,1627,4418
21,122,1627,1749,-1,211,1749,12610
21,130,1749,1879,1,135,1749,4419
21,130,1749,1879,-1,135,1879,12611
21,134,1879,2013,1,112,1879,4420
21,134,1879,2013,-1,112,2013,12612
21,106,2013,2119,1,62,2013,4421
21,106,2013,2119,-1,62,2119,12613
21,125,2119,2244,1,30,2119,4422
21,125,2119,2244,-1,30,2244,12614
21,57,2244,2301,1,15,2244,4423
21,57,2244,2301,-1,15,2301,12615
21,165,2301,2466,1,151,2301,4424
21,165,2301,2466,-1,151,2466,12616
21,171,2466,2637,1,253,2466,4425
21,171,2466,2637,-1,253,2637,12617
21,55,2637,2692,1,193,2637,4426
21,55,2637,2692,-1,193,2692,12618
21,176,2692,2868,1,236,2692,4427
21,176,2692,2868,-1,236,2868,12619
21,207,2868,3075,1,160,2868,4428
21,207,2868,3075,-1,160,3075,12620
21,162,3075,3237,1,155,3075,4429
21,162,3075,3237,-1,155,3237,12621
21,86,3237,3323,1,64,3237,4430
21,86,3237,3323,-1,64,3323,12622
21,75,3323,3398,1,120,3323,4431
21,75,3323,3398,-1,120,3398,12623
21,205,3398,3603,1,66,3398,4432
21,205,3398,3603,-1,66,3603,12624
21,73,3603,3676,1,231,3603,4433
21,73,3603,3676,-1,231,3676,12625
21,179,3676,3855,1,107,3676,4434
21,179,3676,3855,-1,107,3855,12626
21,87,3855,3942,1,218,3855,4435
21,87,3855,3942,-1,218,3942,12627
21,167,3942,4109,1,100,3942,4436
21,167,3942,4109,-1,100,4109,12628
21,80,4109,4189,1,201,4109,4437
21,80,4109,4189,-1,201,4189,12629
21,157,4189,4346,1,174,4189,4438
21,157,4189,4346,-1,174,4346,12630
21,303,4346,4649,1,209,4346,4439
21,303,4346,4649,-1,209,4649,12631
21,191,4649,4840,1,134,4649,4440
21,191,4649,4840,-1,134,4840,12632
21,234,4840,5074,1,9,4840,4441
21,234,4840,5074,-1,9,5074,12633
21,112,5074,5186,1,216,5074,4442
21,112,5074,5186,-1,216,5186,12634
21,204,5186,5390,1,7,5186,4443
21,204,5186,5390,-1,7,5390,12635
21,101,5390,5491,1,108,5390,4444
21,101,5390,5491,-1,108,5491,12636
21,154,5491,5645,1,1,5491,4445
21,154,5491,5645,-1,1,5645,12637
21,135,5645,5780,1,38,5645,4446
21,135,5645,5780,-1,38,5780,12638
21,301,5780,6081,1,142,5780,4447
21,301,5780,6081,-1,142,6081,12639
21,78,6081,6159,1,100,6081,4448
21,78,6081,6159,-1,100,6159,12640
21,133,6159,6292,1,22,6159,4449
21,133,6159,6292,-1,22,6292,12641
21,197,6292,6489,1,154,6292,4450
21,197,6292,6489,-1,154,6489,12642
21,298,6489,6787,1,231,6489,4451
21,298,6489,6787,-1,231,6787,12643
21,122,6787,6909,1,97,6787,4452
21,122,6787,6909,-1,97,6909,12644
21,88,6909,6997,1,132,6909,4453
21,88,6909,6997,-1,132,6997,12645
21,175,6997,7172,1,72,6997,4454
21,175,6997,7172,-1,72,7172,12646
21,89,7172,7261,1,144,7172,4455
21,89,7172,7261,-1,144,7261,12647
21,210,7261,7471,1,216,7261,4456
21,210,7261,7471,-1,216,7471,12648
21,127,7471,7598,1,74,7471,4457
21,127,7471,7598,-1,74,7598,12649
21,465,7598,8063,1,44,7598,4458
21,465,7598,8063,-1,44,8063,12650
21,53,8063,8116,1,73,8063,4459
21,53,8063,8116,-1,73,8116,12651
21,162,8116,8278,1,151,8116,4460
21,162,8116,8278,-1,151,8278,12652
21,178,8278,8456,1,36,8278,4461
21,178,8278,8456,-1,36,8456,12653
21,99,8456,8555,1,76,8456,4462
21,99,8456,8555,-1,76,8555,12654
21,92,8555,8647,1,243,8555,4463
21,92,8555,8647,-1,243,8647,12655
21,171,8647,8818,1,46,8647,4464
21,171,8647,8818,-1,46,8818,12656
21,78,8818,8896,1,79,8818,4465
21,78,8818,8896,-1,79,8896,12657
21,93,8896,8989,1,240,8896,4466
21,93,8896,8989,-1,240,8989,12658
21,178,8989,9167,1,91,8989,4467
21,178,8989,9167,-1,91,9167,12659
21,43,9167,9210,1,204,9167,4468
21,43,9167,9210,-1,204,9210,12660
21,134,9210,9344,1,70,9210,4469
21,134,9210,9344,-1,70,9344,12661
21,187,9344,9531,1,29,9344,4470
21,187,9344,9531,-1,29,9531,12662
21,234,9531,9765,1,181,9531,4471
21,234,9531,9765,-1,181,9765,12663
21,41,9765,9806,1,35,9765,4472
21,41,9765,9806,-1,35,9806,12664
21,140,9806,9946,1,21,9806,4473
21,140,9806,9946,-1,21,9946,12665
21,34,9946,9980,1,253,9946,4474
21,34,9946,9980,-1,253,9980,12666
21,299,9980,10279,1,196,9980,4475
21,299,9980,10279,-1,196,10279,12667
21,168,10279,10447,1,90,10279,4476
21,168,10279,10447,-1,90,10447,12668
21,82,10447,10529,1,12,10447,4477
21,82,10447,10529,-1,12,10529,12669
21,206,10529,10735,1,15,10529,4478
21,206,10529,10735,-1,15,10735,12670
21,126,10735,10861,1,57,10735,4479
21,126,10735,10861,-1,57,10861,12671
21,54,10861,10915,1,133,10861,4480
21,54,10861,10915,-1,133,10915,12672
21,140,10915,11055,1,206,10915,4481
21,140,10915,11055,-1,206,11055,12673
21,55,11055,11110,1,185,11055,4482
21,55,11055,11110,-1,185,11110,12674
21,81,11110,11191,1,44,11110,4483
21,81,11110,11191,-1,44,11191,12675
21,52,11191,11243,1,220,11191,4484
21,52,11191,11243,-1,220,11243,12676
21,88,11243,11331,1,40,11243,4485
21,88,11243,11331,-1,40,11331,12677
21,233,11331,11564,1,163,11331,4486
21,233,11331,11564,-1,163,11564,12678
21,108,11564,11672,1,117,11564,4487
21,108,11564,11672,-1,117,11672,12679
21,256,11672,11928,1,9,11672,4488
21,256,11672,11928,-1,9,11928,12680
21,127,11928,12055,1,220,11928,4489
21,127,11928,12055,-1,220,12055,12681
21,103,12055,12158,1,245,12055,4490
21,103,12055,12158,-1,245,12158,12682
21,108,12158,12266,1,254,12158,4491
21,108,12158,12266,-1,254,12266,12683
21,51,12266,12317,1,244,12266,4492
21,51,12266,12317,-1,244,12317,12684
21,107,12317,12424,1,215,12317,4493
21,107,12317,12424,-1,215,12424,12685
21,83,12424,12507,1,60,12424,4494
21,83,12424,12507,-1,60,12507,12686
21,117,12507,12624,1,39,12507,4495
21,117,12507,12624,-1,39,12624,12687
21,132,12624,12756,1,230,12624,4496
21,132,12624,12756,-1,230,12756,12688
21,103,12756,12859,1,17,12756,4497
21,103,12756,12859,-1,17,12859,12689
21,105,12859,12964,1,207,12859,4498
21,105,12859,12964,-1,207,12964,12690
21,109,12964,13073,1,73,12964,4499
21,109,12964,13073,-1,73,13073,12691
21,87,13073,13160,1,150,13073,4500
21,87,13073,13160,-1,150,13160,12692
21,44,13160,13204,1,195,13160,4501
21,44,13160,13204,-1,195,13204,12693
21,128,13204,13332,1,160,13204,4502
21,128,13204,13332,-1,160,13332,12694
21,172,13332,13504,1,133,13332,4503
21,172,13332,13504,-1,133,13504,12695
21,161,13504,13665,1,82,13504,4504
21,161,13504,13665,-1,82,13665,12696
21,163,13665,13828,1,112,13665,4505
21,163,13665,13828,-1,112,13828,12697
21,157,13828,13985,1,144,13828,4506
21,157,13828,13985,-1,144,13985,12698
21,214,13985,14199,1,214,13985,4507
21,214,13985,14199,-1,214,14199,12699
21,124,14199,14323,1,99,14199,4508
21,124,14199,14323,-1,99,14323,12700
21,165,14323,14488,1,99,14323,4509
21,165,14323,14488,-1,99,14488,12701
21,30,14488,14518,1,157,14488,4510
21,30,14488,14518,-1,157,14518,12702
21,146,14518,14664,1,180,14518,4511
21,146,14518,14664,-1,180,14664,12703
21,188,14664,14852,1,155,14664,4512
21,188,14664,14852,-1,155,14852,12704
21,69,14852,14921,1,225,14852,4513
21,69,14852,14921,-1,225,14921,12705
21,167,14921,15088,1,156,14921,4514
21,167,14921,15088,-1,156,15088,12706
21,182,15088,15270,1,145,15088,4515
21,182,15088,15270,-1,145,15270,12707
21,123,15270,15393,1,72,15270,4516
21,123,15270,15393,-1,72,15393,12708
21,43,15393,15436,1,29,15393,4517
21,43,15393,15436,-1,29,15436,12709
21,96,15436,15532,1,51,15436,4518
21,96,15436,15532,-1,51,15532,12710
21,51,15532,15583,1,52,15532,4519
21,51,15532,15583,-1,52,15583,12711
21,121,15583,15704,1,79,15583,4520
21,121,15583,15704,-1,79,15704,12712
21,116,15704,15820,1,129,15704,4521
21,116,15704,15820,-1,129,15820,12713
21,77,15820,15897,1,157,15820,4522
21,77,15820,15897,-1,157,15897,12714
21,139,15897,16036,1,211,15897,4523
21,139,15897,16036,-1,211,16036,12715
21,48,16036,16084,1,72,16036,4524
21,48,16036,16084,-1,72,16084,12716
21,70,16084,16154,1,253,16084,4525
21,70,16084,16154,-1,253,16154,12717
21,129,16154,16283,1,98,16154,4526
21,129,16154,16283,-1,98,16283,12718
21,41,16283,16324,1,136,16283,4527
21,41,16283,16324,-1,136,16324,12719
21,108,16324,16432,1,29,16324,4528
21,108,16324,16432,-1,29,16432,12720
21,121,16432,16553,1,177,16432,4529
21,121,16432,16553,-1,177,16553,12721
21,25,16553,16578,1,23,16553,4530
21,25,16553,16578,-1,23,16578,12722
21,145,16578,16723,1,170,16578,4531
21,145,16578,16723,-1,170,16723,12723
21,199,16723,16922,1,135,16723,4532
21,199,16723,16922,-1,135,16922,12724
21,127,16922,17049,1,63,16922,4533
21,127,16922,17049,-1,63,17049,12725
21,81,17049,17130,1,14,17049,4534
21,81,17049,17130,-1,14,17130,12726
21,144,17130,17274,1,236,17130,4535
21,144,17130,17274,-1,236,17274,12727
21,213,17274,17487,1,70,17274,4536
21,213,17274,17487,-1,70,17487,12728
21,261,17487,17748,1,207,17487,4537
21,261,17487,17748,-1,207,17748,12729
21,89,17748,17837,1,199,17748,4538
21,89,17748,17837,-1,199,17837,12730
21,105,17837,17942,1,55,17837,4539
21,105,17837,17942,-1,55,17942,12731
21,120,17942,18062,1,95,17942,4540
21,120,17942,18062,-1,95,18062,12732
21,87,18062,18149,1,114,18062,4541
21,87,18062,18149,-1,114,18149,12733
21,47,18149,18196,1,79,18149,4542
21,47,18149,18196,-1,79,18196,12734
21,94,18196,18290,1,163,18196,4543
21,94,18196,18290,-1,163,18290,12735
21,135,18290,18425,1,41,18290,4544
21,135,18290,18425,-1,41,18425,12736
21,285,18425,18710,1,222,18425,4545
21,285,18425,18710,-1,222,18710,12737
21,159,18710,18869,1,48,18710,4546
21,159,18710,18869,-1,48,18869,12738
21,196,18869,19065,1,250,18869,4547
21,196,18869,19065,-1,250,19065,12739
21,83,19065,19148,1,75,19065,4548
21,83,19065,19148,-1,75,19148,12740
21,60,19148,19208,1,86,19148,4549
21,60,19148,19208,-1,86,19208,12741
21,102,19208,19310,1,23,19208,4550
21,102,19208,19310,-1,23,19310,12742
21,220,19310,19530,1,35,19310,4551
21,220,19310,19530,-1,35,19530,12743
21,121,19530,19651,1,203,19530,4552
21,121,19530,19651,-1,203,19651,12744
21,114,19651,19765,1,45,19651,4553
21,114,19651,19765,-1,45,19765,12745
21,119,19765,19884,1,240,19765,4554
21,119,19765,19884,-1,240,19884,12746
21,77,19884,19961,1,99,19884,4555
21,77,19884,19961,-1,99,19961,12747
21,131,19961,20092,1,123,19961,4556
21,131,19961,20092,-1,123,20092,12748
21,195,20092,20287,1,1,20092,4557
21,195,20092,20287,-1,1,20287,12749
21,70,20287,20357,1,131,20287,4558
21,70,20287,20357,-1,131,20357,12750
21,89,20357,20446,1,51,20357,4559
21,89,20357,20446,-1,51,20446,12751
21,121,20446,20567,1,53,20446,4560
21,121,20446,20567,-1,53,20567,12752
21,183,20567,20750,1,16,20567,4561
21,183,20567,20750,-1,16,20750,12753
21,81,20750,20831,1,202,20750,4562
21,81,20750,20831,-1,202,20831,12754
21,82,20831,20913,1,217,20831,4563
21,82,20831,20913,-1,217,20913,12755
21,82,20913,20995,1,157,20913,4564
21,82,20913,20995,-1,157,20995,12756
21,160,20995,21155,1,134,20995,4565
21,160,20995,21155,-1,134,21155,12757
21,167,21155,21322,1,110,21155,4566
21,167,21155,21322,-1,110,21322,12758
21,63,21322,21385,1,123,21322,4567
21,63,21322,21385,-1,123,21385,12759
21,98,21385,21483,1,95,21385,4568
21,98,21385,21483,-1,95,21483,12760
21,181,21483,21664,1,49,21483,4569
21,181,21483,21664,-1,49,21664,12761
21,88,21664,21752,1,52,21664,4570
21,88,21664,21752,-1,52,21752,12762
21,225,21752,21977,1,32,21752,4571
21,225,21752,21977,-1,32,21977,12763
21,113,21977,22090,1,195,21977,4572
21,113,21977,22090,-1,195,22090,12764
21,105,22090,22195,1,158,22090,4573
21,105,22090,22195,-1,158,22195,12765
21,46,22195,22241,1,148,22195,4574
21,46,22195,22241,-1,148,22241,12766
21,136,22241,22377,1,126,22241,4575
21,136,22241,22377,-1,126,22377,12767
21,131,22377,22508,1,216,22377,4576
21,131,22377,22508,-1,216,22508,12768
21,217,22508,22725,1,70,22508,4577
21,217,22508,22725,-1,70,22725,12769
21,156,22725,22881,1,226,22725,4578
21,156,22725,22881,-1,226,22881,12770
21,219,22881,23100,1,162,22881,4579
21,219,22881,23100,-1,162,23100,12771
21,106,23100,23206,1,136,23100,4580
21,106,23100,23206,-1,136,23206,12772
21,208,23206,23414,1,179,23206,4581
21,208,23206,23414,-1,179,23414,12773
21,88,23414,23502,1,241,23414,4582
21,88,23414,23502,-1,241,23502,12774
21,165,23502,23667,1,233,23502,4583
21,165,23502,23667,-1,233,23667,12775
21,97,23667,23764,1,149,23667,4584
21,97,23667,23764,-1,149,23764,12776
21,124,23764,23888,1,74,23764,4585
21,124,23764,23888,-1,74,23888,12777
21,287,23888,24175,1,153,23888,4586
21,287,23888,24175,-1,153,24175,12778
21,117,24175,24292,1,207,24175,4587
21,117,24175,24292,-1,207,24292,12779
21,148,24292,24440,1,21,24292,4588
21,148,24292,24440,-1,21,24440,12780
21,127,24440,24567,1,170,24440,4589
21,127,24440,24567,-1,170,24567,12781
21,96,24567,24663,1,184,24567,4590
21,96,24567,24663,-1,184,24663,12782
21,228,24663,24891,1,12,24663,4591
21,228,24663,24891,-1,12,24891,12783
21,169,24891,25060,1,28,24891,4592
21,169,24891,25060,-1,28,25060,12784
21,112,25060,25172,1,118,25060,4593
21,112,25060,25172,-1,118,25172,12785
21,188,25172,25360,1,39,25172,4594
21,188,25172,25360,-1,39,25360,12786
21,103,25360,25463,1,118,25360,4595
21,103,25360,25463,-1,118,25463,12787
21,130,25463,25593,1,244,25463,4596
21,130,25463,25593,-1,244,25593,12788
21,151,25593,25744,1,238,25593,4597
21,151,25593,25744,-1,238,25744,12789
21,100,25744,25844,1,104,25744,4598
21,100,25744,25844,-1,104,25844,12790
21,92,25844,25936,1,100,25844,4599
21,92,25844,25936,-1,100,25936,12791
21,123,25936,26059,1,204,25936,4600
21,123,25936,26059,-1,204,26059,12792
21,100,26059,26159,1,250,26059,4601
21,100,26059,26159,-1,250,26159,12793
21,201,26159,26360,1,200,26159,4602
21,201,26159,26360,-1,200,26360,12794
21,97,26360,26457,1,204,26360,4603
21,97,26360,26457,-1,204,26457,12795
21,166,26457,26623,1,253,26457,4604
21,166,26457,26623,-1,253,26623,12796
21,240,26623,26863,1,52,26623,4605
21,240,26623,26863,-1,52,26863,12797
21,112,26863,26975,1,240,26863,4606
21,112,26863,26975,-1,240,26975,12798
21,119,26975,27094,1,88,26975,4607
21,119,26975,27094,-1,88,27094,12799
21,190,27094,27284,1,48,27094,4608
21,190,27094,27284,-1,48,27284,12800
21,89,27284,27373,1,148,27284,4609
21,89,27284,27373,-1,148,27373,12801
21,53,27373,27426,1,78,27373,4610
21,53,27373,27426,-1,78,27426,12802
21,266,27426,27692,1,228,27426,4611
21,266,27426,27692,-1,228,27692,12803
21,186,27692,27878,1,121,27692,4612
21,186,27692,27878,-1,121,27878,12804
21,108,27878,27986,1,194,27878,4613
21,108,27878,27986,-1,194,27986,12805
21,139,27986,28125,1,108,27986,4614
21,139,27986,28125,-1,108,28125,12806
21,146,28125,28271,1,255,28125,4615
21,146,28125,28271,-1,255,28271,12807
21,185,28271,28456,1,33,28271,4616
21,185,28271,28456,-1,33,28456,12808
21,127,28456,28583,1,7,28456,4617
21,127,28456,28583,-1,7,28583,12809
21,91,28583,28674,1,70,28583,4618
21,91,28583,28674,-1,70,28674,12810
21,108,28674,28782,1,10,28674,4619
21,108,28674,28782,-1,10,28782,12811
21,56,28782,28838,1,111,28782,4620
21,56,28782,28838,-1,111,28838,12812
21,117,28838,28955,1,17,28838,4621
21,117,28838,28955,-1,17,28955,12813
21,97,28955,29052,1,182,28955,4622
21,97,28955,29052,-1,182,29052,12814
21,119,29052,29171,1,215,29052,4623
21,119,29052,29171,-1,215,29171,12815
21,110,29171,29281,1,254,29171,4624
21,110,29171,29281,-1,254,29281,12816
21,230,29281,29511,1,67,29281,4625
21,230,29281,29511,-1,67,29511,12817
21,102,29511,29613,1,229,29511,4626
21,102,29511,29613,-1,229,29613,12818
21,114,29613,29727,1,75,29613,4627
21,114,29613,29727,-1,75,29727,12819
21,215,29727,29942,1,196,29727,4628
21,215,29727,29942,-1,196,29942,12820
21,99,29942,30041,1,10,29942,4629
21,99,29942,30041,-1,10,30041,12821
21,138,30041,30179,1,128,30041,4630
21,138,30041,30179,-1,128,30179,12822
21,144,30179,30323,1,69,30179,4631
21,144,30179,30323,-1,69,30323,12823
21,115,30323,30438,1,219,30323,4632
21,115,30323,30438,-1,219,30438,12824
21,182,30438,30620,1,203,30438,4633
21,182,30438,30620,-1,203,30620,12825
21,196,30620,30816,1,127,30620,4634
21,196,30620,30816,-1,127,30816,12826
21,89,30816,30905,1,233,30816,4635
21,89,30816,30905,-1,233,30905,12827
21,96,30905,31001,1,139,30905,4636
21,96,30905,31001,-1,139,31001,12828
21,110,31001,31111,1,221,31001,4637
21,110,31001,31111,-1,221,31111,12829
21,157,31111,31268,1,110,31111,4638
21,157,31111,31268,-1,110,31268,12830
21,38,31268,31306,1,249,31268,4639
21,38,31268,31306,-1,249,31306,12831
21,171,31306,31477,1,38,31306,4640
21,171,31306,31477,-1,38,31477,12832
21,75,31477,31552,1,119,31477,4641
21,75,31477,31552,-1,119,31552,12833
22,56,0,56,1,246,0,6738
22,56,0,56,-1,246,56,14930
22,229,56,285,1,175,56,6739
22,229,56,285,-1,175,285,14931
22,172,285,457,1,30,285,6740
22,172,285,457,-1,30,457,14932
22,74,457,531,1,254,457,6741
22,74,457,531,-1,254,531,14933
22,50,531,581,1,110,531,6742
22,50,531,581,-1,110,581,14934
22,127,581,708,1,90,581,6743
22,127,581,708,-1,90,708,14935
22,168,708,876,1,193,708,6744
22,168,708,876,-1,193,876,14936
22,166,876,1042,1,42,876,6745
22,166,876,1042,-1,42,1042,14937
22,87,1042,1129,1,219,1042,6746
22,87,1042,1129,-1,219,1129,14938
22,188,1129,1317,1,2,1129,6747
22,188,1129,1317,-1,2,1317,14939
22,150,1317,1467,1,39,1317,6748
22,150,1317,1467,-1,39,1467,14940
22,84,1467,1551,1,15,1467,6749
22,84,1467,1551,-1,15,1551,14941
22,183,1551,1734,1,255,1551,6750
22,183,1551,1734,-1,255,1734,14942
22,150,1734,1884,1,225,1734,6751
22,150,1734,1884,-1,225,1884,14943
22,88,1884,1972,1,210,1884,6752
22,88,1884,1972,-1,210,1972,14944
22,239,1972,2211,1,68,1972,6753
22,239,1972,2211,-1,68,2211,14945
22,90,2211,2301,1,9,2211,6754
22,90,2211,2301,-1,9,2301,14946
22,77,2301,2378,1,115,2301,6755
22,77,2301,2378,-1,115,2378,14947
22,68,2378,2446,1,177,2378,6756
22,68,2378,2446,-1,177,2446,14948
22,105,2446,2551,1,104,2446,6757
22,105,2446,2551,-1,104,2551,14949
22,168,2551,2719,1,19,2551,6758
22,168,2551,2719,-1,19,2719,14950
22,117,2719,2836,1,223,2719,6759
22,117,2719,2836,-1,223,2836,14951
22,55,2836,2891,1,81,2836,6760
22,55,2836,2891,-1,81,2891,14952
22,141,2891,3032,1,23,2891,6761
22,141,2891,3032,-1,23,3032,14953
22,193,3032,3225,1,15,3032,6762
22,193,3032,3225,-1,15,3225,14954
22,114,3225,3339,1,22,3225,6763
22,114,3225,3339,-1,22,3339,14955
22,111,3339,3450,1,88,3339,6764
22,111,3339,3450,-1,88,3450,14956
22,42,3450,3492,1,29,3450,6765
22,42,3450,3492,-1,29,3492,14957
22,179,3492,3671,1,157,3492,6766
22,179,3492,3671,-1,157,3671,14958
22,47,3671,3718,1,128,3671,6767
22,47,3671,3718,-1,128,3718,14959
22,211,3718,3929,1,92,3718,6768
22,211,3718,3929,-1,92,3929,14960
22,180,3929,4109,1,121,3929,6769
22,180,3929,4109,-1,121,4109,14961
22,238,4109,4347,1,5,4109,6770
22,238,4109,4347,-1,5,4347,14962
22,112,4347,4459,1,161,4347,6771
22,112,4347,4459,-1,161,4459,14963
22,130,4459,4589,1,78,4459,6772
22,130,4459,4589,-1,78,4589,14964
22,250,4589,4839,1,129,4589,6773
22,250,4589,4839,-1,129,4839,14965
22,141,4839,4980,1,252,4839,6774
22,141,4839,4980,-1,252,4980,14966
22,211,4980,5191,1,141,4980,6775
22,211,4980,5191,-1,141,5191,14967
22,115,5191,5306,1,73,5191,6776
22,115,5191,5306,-1,73,5306,14968
22,179,5306,5485,1,184,5306,6777
22,179,5306,5485,-1,184,5485,14969
22,77,5485,5562,1,62,5485,6778
22,77,5485,5562,-1,62,5562,14970
22,74,5562,5636,1,146,5562,6779
22,74,5562,5636,-1,146,5636,14971
22,58,5636,5694,1,226,5636,6780
22,58,5636,5694,-1,226,5694,14972
22,66,5694,5760,1,69,5694,6781
22,66,5694,5760,-1,69,5760,14973
22,241,5760,6001,1,248,5760,6782
22,241,5760,6001,-1,248,6001,14974
22,102,6001,6103,1,131,6001,6783
22,102,6001,6103,-1,131,6103,14975
22,79,6103,6182,1,58,6103,6784
22,79,6103,6182,-1,58,6182,14976
22,177,6182,6359,1,215,6182,6785
22,177,6182,6359,-1,215,6359,14977
22,118,6359,6477,1,187,6359,6786
22,118,6359,6477,-1,187,6477,14978
22,29,6477,6506,1,75,6477,6787
22,29,6477,6506,-1,75,6506,14979
22,108,6506,6614,1,124,6506,6788
22,108,6506,6614,-1,124,6614,14980
22,232,6614,6846,1,215,6614,6789
22,232,6614,6846,-1,215,6846,14981
22,194,6846,7040,1,45,6846,6790
22,194,6846,7040,-1,45,7040,14982
22,142,7040,7182,1,149,7040,6791
22,142,7040,7182,-1,149,7182,14983
22,67,7182,7249,1,193,7182,6792
22,67,7182,7249,-1,193,7249,14984
22,84,7249,7333,1,98,7249,6793
22,84,7249,7333,-1,98,7333,14985
22,59,7333,7392,1,62,7333,6794
22,59,7333,7392,-1,62,7392,14986
22,138,7392,7530,1,65,7392,6795
22,138,7392,7530,-1,65,7530,14987
22,93,7530,7623,1,140,7530,6796
22,93,7530,7623,-1,140,7623,14988
22,135,7623,7758,1,99,7623,6797
22,135,7623,7758,-1,99,7758,14989
22,129,7758,7887,1,209,7758,6798
22,129,7758,7887,-1,209,7887,14990
22,86,7887,7973,1,23,7887,6799
22,86,7887,7973,-1,23,7973,14991
22,116,7973,8089,1,209,7973,6800
22,116,7973,8089,-1,209,8089,14992
22,149,8089,8238,1,148,8089,6801
22,149,8089,8238,-1,148,8238,14993
22,189,8238,8427,1,162,8238,6802
22,189,8238,8427,-1,162,8427,14994
22,60,8427,8487,1,15,8427,6803
22,60,8427,8487,-1,15,8487,14995
22,174,8487,8661,1,104,8487,6804
22,174,8487,8661,-1,104,8661,14996
22,77,8661,8738,1,144,8661,6805
22,77,8661,8738,-1,144,8738,14997
22,130,8738,8868,1,126,8738,6806
22,130,8738,8868,-1,126,8868,14998
22,116,8868,8984,1,244,8868,6807
22,116,8868,8984,-1,244,8984,14999
22,210,8984,9194,1,233,8984,6808
22,210,8984,9194,-1,233,9194,15000
22,137,9194,9331,1,230,9194,6809
22,137,9194,9331,-1,230,9331,15001
22,228,9331,9559,1,180,9331,6810
22,228,9331,9559,-1,180,9559,15002
22,41,9559,9600,1,119,9559,6811
22,41,9559,9600,-1,119,9600,15003
22,106,9600,9706,1,57,9600,6812
22,106,9600,9706,-1,57,9706,15004
22,78,9706,9784,1,16,9706,6813
22,78,9706,9784,-1,16,9784,15005
22,78,9784,9862,1,221,9784,6814
22,78,9784,9862,-1,221,9862,15006
22,50,9862,9912,1,33,9862,6815
22,50,9862,9912,-1,33,9912,15007
22,209,9912,10121,1,52,9912,6816
22,209,9912,10121,-1,52,10121,15008
22,70,10121,10191,1,136,10121,6817
22,70,10121,10191,-1,136,10191,15009
22,135,10191,10326,1,120,10191,6818
22,135,10191,10326,-1,120,10326,15010
22,75,10326,10401,1,48,10326,6819
22,75,10326,10401,-1,48,10401,15011
22,99,10401,10500,1,246,10401,6820
22,99,10401,10500,-1,246,10500,15012
22,82,10500,10582,1,87,10500,6821
22,82,10500,10582,-1,87,10582,15013
22,127,10582,10709,1,115,10582,6822
22,127,10582,10709,-1,115,10709,15014
22,96,10709,10805,1,35,10709,6823
22,96,10709,10805,-1,35,10805,15015
22,121,10805,10926,1,65,10805,6824
22,121,10805,10926,-1,65,10926,15016
22,76,10926,11002,1,157,10926,6825
22,76,10926,11002,-1,157,11002,15017
22,138,11002,11140,1,44,11002,6826
22,138,11002,11140,-1,44,11140,15018
22,49,11140,11189,1,127,11140,6827
22,49,11140,11189,-1,127,11189,15019
22,233,11189,11422,1,212,11189,6828
22,233,11189,11422,-1,212,11422,15020
22,63,11422,11485,1,68,11422,6829
22,63,11422,11485,-1,68,11485,15021
22,224,11485,11709,1,139,11485,6830
22,224,11485,11709,-1,139,11709,15022
22,95,11709,11804,1,219,11709,6831
22,95,11709,11804,-1,219,11804,15023
22,201,11804,12005,1,27,11804,6832
22,201,11804,12005,-1,27,12005,15024
22,57,12005,12062,1,137,12005,6833
22,57,12005,12062,-1,137,12062,15025
22,71,12062,12133,1,105,12062,6834
22,71,12062,12133,-1,105,12133,15026
22,220,12133,12353,1,70,12133,6835
22,220,12133,12353,-1,70,12353,15027
22,41,12353,12394,1,11,12353,6836
22,41,12353,12394,-1,11,12394,15028
22,110,12394,12504,1,188,12394,6837
22,110,12394,12504,-1,188,12504,15029
22,118,12504,12622,1,66,12504,6838
22,118,12504,12622,-1,66,12622,15030
22,145,12622,12767,1,33,12622,6839
22,145,12622,12767,-1,33,12767,15031
22,91,12767,12858,1,125,12767,6840
22,91,12767,12858,-1,125,12858,15032
22,50,12858,12908,1,106,12858,6841
22,50,12858,12908,-1,106,12908,15033
22,117,12908,13025,1,249,12908,6842
22,117,12908,13025,-1,249,13025,15034
22,186,13025,13211,1,3,13025,6843
22,186,13025,13211,-1,3,13211,15035
22,102,13211,13313,1,248,13211,6844
22,102,13211,13313,-1,248,13313,15036
22,335,13313,13648,1,226,13313,6845
22,335,13313,13648,-1,226,13648,15037
22,92,13648,13740,1,134,13648,6846
22,92,13648,13740,-1,134,13740,15038
22,115,13740,13855,1,164,13740,6847
22,115,13740,13855,-1,164,13855,15039
22,101,13855,13956,1,59,13855,6848
22,101,13855,13956,-1,59,13956,15040
22,59,13956,14015,1,19,13956,6849
22,59,13956,14015,-1,19,14015,15041
22,193,14015,14208,1,249,14015,6850
22,193,14015,14208,-1,249,14208,15042
22,122,14208,14330,1,179,14208,6851
22,122,14208,14330,-1,179,14330,15043
22,83,14330,14413,1,123,14330,6852
22,83,14330,14413,-1,123,14413,15044
22,55,14413,14468,1,234,14413,6853
22,55,14413,14468,-1,234,14468,15045
22,145,14468,14613,1,212,14468,6854
22,145,14468,14613,-1,212,14613,15046
22,289,14613,14902,1,185,14613,6855
22,289,14613,14902,-1,185,14902,15047
22,112,14902,15014,1,174,14902,6856
22,112,14902,15014,-1,174,15014,15048
22,102,15014,15116,1,107,15014,6857
22,102,15014,15116,-1,107,15116,15049
22,142,15116,15258,1,200,15116,6858
22,142,15116,15258,-1,200,15258,15050
22,117,15258,15375,1,99,15258,6859
22,117,15258,15375,-1,99,15375,15051
22,167,15375,15542,1,5,15375,6860
22,167,15375,15542,-1,5,15542,15052
22,263,15542,15805,1,210,15542,6861
22,263,15542,15805,-1,210,15805,15053
22,117,15805,15922,1,256,15805,6862
22,117,15805,15922,-1,256,15922,15054
22,213,15922,16135,1,16,15922,6863
22,213,15922,16135,-1,16,16135,15055
22,81,16135,16216,1,23,16135,6864
22,81,16135,16216,-1,23,16216,15056
22,153,16216,16369,1,58,16216,6865
22,153,16216,16369,-1,58,16369,15057
22,337,16369,16706,1,177,16369,6866
22,337,16369,16706,-1,177,16706,15058
22,121,16706,16827,1,228,16706,6867
22,121,16706,16827,-1,228,16827,15059
22,85,16827,16912,1,8,16827,6868
22,85,16827,16912,-1,8,16912,15060
22,200,16912,17112,1,144,16912,6869
22,200,16912,17112,-1,144,17112,15061
22,157,17112,17269,1,90,17112,6870
22,157,17112,17269,-1,90,17269,15062
22,108,17269,17377,1,17,17269,6871
22,108,17269,17377,-1,17,17377,15063
22,90,17377,17467,1,151,17377,6872
22,90,17377,17467,-1,151,17467,15064
22,155,17467,17622,1,26,17467,6873
22,155,17467,17622,-1,26,17622,15065
22,142,17622,17764,1,209,17622,6874
22,142,17622,17764,-1,209,17764,15066
22,136,17764,17900,1,156,17764,6875
22,136,17764,17900,-1,156,17900,15067
22,104,17900,18004,1,240,17900,6876
22,104,17900,18004,-1,240,18004,15068
22,225,18004,18229,1,201,18004,6877
22,225,18004,18229,-1,201,18229,15069
22,44,18229,18273,1,226,18229,6878
22,44,18229,18273,-1,226,18273,15070
22,106,18273,18379,1,155,18273,6879
22,106,18273,18379,-1,155,18379,15071
22,270,18379,18649,1,18,18379,6880
22,270,18379,18649,-1,18,18649,15072
22,22,18649,18671,1,169,18649,6881
22,22,18649,18671,-1,169,18671,15073
22,248,18671,18919,1,213,18671,6882
22,248,18671,18919,-1,213,18919,15074
22,24,18919,18943,1,19,18919,6883
22,24,18919,18943,-1,19,18943,15075
22,108,18943,19051,1,139,18943,6884
22,108,18943,19051,-1,139,19051,15076
22,197,19051,19248,1,177,19051,6885
22,197,19051,19248,-1,177,19248,15077
22,110,19248,19358,1,154,19248,6886
22,110,19248,19358,-1,154,19358,15078
22,112,19358,19470,1,116,19358,6887
22,112,19358,19470,-1,116,19470,15079
22,159,19470,19629,1,61,19470,6888
22,159,19470,19629,-1,61,19629,15080
22,144,19629,19773,1,92,19629,6889
22,144,19629,19773,-1,92,19773,15081
22,126,19773,19899,1,221,19773,6890
22,126,19773,19899,-1,221,19899,15082
22,257,19899,20156,1,213,19899,6891
22,257,19899,20156,-1,213,20156,15083
22,84,20156,20240,1,244,20156,6892
22,84,20156,20240,-1,244,20240,15084
22,138,20240,20378,1,62,20240,6893
22,138,20240,20378,-1,62,20378,15085
22,31,20378,20409,1,240,20378,6894
22,31,20378,20409,-1,240,20409,15086
22,109,20409,20518,1,172,20409,6895
22,109,20409,20518,-1,172,20518,15087
22,117,20518,20635,1,15,20518,6896
22,117,20518,20635,-1,15,20635,15088
22,202,20635,20837,1,194,20635,6897
22,202,20635,20837,-1,194,20837,15089
22,33,20837,20870,1,31,20837,6898
22,33,20837,20870,-1,31,20870,15090
22,85,20870,20955,1,155,20870,6899
22,85,20870,20955,-1,155,20955,15091
22,31,20955,20986,1,143,20955,6900
22,31,20955,20986,-1,143,20986,15092
22,256,20986,21242,1,93,20986,6901
22,256,20986,21242,-1,93,21242,15093
22,131,21242,21373,1,236,21242,6902
22,131,21242,21373,-1,236,21373,15094
22,150,21373,21523,1,122,21373,6903
22,150,21373,21523,-1,122,21523,15095
22,47,21523,21570,1,182,21523,6904
22,47,21523,21570,-1,182,21570,15096
22,20,21570,21590,1,38,21570,6905
22,20,21570,21590,-1,38,21590,15097
22,96,21590,21686,1,181,21590,6906
22,96,21590,21686,-1,181,21686,15098
22,184,21686,21870,1,82,21686,6907
22,184,21686,21870,-1,82,21870,15099
22,84,21870,21954,1,143,21870,6908
22,84,21870,21954,-1,143,21954,15100
22,304,21954,22258,1,125,21954,6909
22,304,21954,22258,-1,125,22258,15101
22,121,22258,22379,1,31,22258,6910
22,121,22258,22379,-1,31,22379,15102
22,44,22379,22423,1,225,22379,6911
22,44,22379,22423,-1,225,22423,15103
22,291,22423,22714,1,69,22423,6912
22,291,22423,22714,-1,69,22714,15104
22,147,22714,22861,1,36,22714,6913
22,147,22714,22861,-1,36,22861,15105
22,139,22861,23000,1,113,22861,6914
22,139,22861,23000,-1,113,23000,15106
22,56,23000,23056,1,58,23000,6915
22,56,23000,23056,-1,58,23056,15107
22,91,23056,23147,1,67,23056,6916
22,91,23056,23147,-1,67,23147,15108
22,105,23147,23252,1,125,23147,6917
22,105,23147,23252,-1,125,23252,15109
22,98,23252,23350,1,236,23252,6918
22,98,23252,23350,-1,236,23350,15110
22,222,23350,23572,1,227,23350,6919
22,222,23350,23572,-1,227,23572,15111
22,215,23572,23787,1,41,23572,6920
22,215,23572,23787,-1,41,23787,15112
22,192,23787,23979,1,225,23787,6921
22,192,23787,23979,-1,225,23979,15113
22,89,23979,24068,1,249,23979,6922
22,89,23979,24068,-1,249,24068,15114
22,88,24068,24156,1,14,24068,6923
22,88,24068,24156,-1,14,24156,15115
22,78,24156,24234,1,33,24156,6924
22,78,24156,24234,-1,33,24234,15116
22,125,24234,24359,1,22,24234,6925
22,125,24234,24359,-1,22,24359,15117
22,106,24359,24465,1,141,24359,6926
22,106,24359,24465,-1,141,24465,15118
22,77,24465,24542,1,232,24465,6927
22,77,24465,24542,-1,232,24542,15119
22,283,24542,24825,1,238,24542,6928
22,283,24542,24825,-1,238,24825,15120
22,118,24825,24943,1,117,24825,6929
22,118,24825,24943,-1,117,24943,15121
22,164,24943,25107,1,109,24943,6930
22,164,24943,25107,-1,109,25107,15122
22,145,25107,25252,1,182,25107,6931
22,145,25107,25252,-1,182,25252,15123
22,161,25252,25413,1,48,25252,6932
22,161,25252,25413,-1,48,25413,15124
22,68,25413,25481,1,89,25413,6933
22,68,25413,25481,-1,89,25481,15125
22,157,25481,25638,1,116,25481,6934
22,157,25481,25638,-1,116,25638,15126
22,101,25638,25739,1,101,25638,6935
22,101,25638,25739,-1,101,25739,15127
22,118,25739,25857,1,27,25739,6936
22,118,25739,25857,-1,27,25857,15128
22,305,25857,26162,1,216,25857,6937
22,305,25857,26162,-1,216,26162,15129
22,96,26162,26258,1,160,26162,6938
22,96,26162,26258,-1,160,26258,15130
22,217,26258,26475,1,11,26258,6939
22,217,26258,26475,-1,11,26475,15131
22,213,26475,26688,1,175,26475,6940
22,213,26475,26688,-1,175,26688,15132
22,97,26688,26785,1,202,26688,6941
22,97,26688,26785,-1,202,26785,15133
22,201,26785,26986,1,90,26785,6942
22,201,26785,26986,-1,90,26986,15134
22,121,26986,27107,1,207,26986,6943
22,121,26986,27107,-1,207,27107,15135
22,178,27107,27285,1,99,27107,6944
22,178,27107,27285,-1,99,27285,15136
22,20,27285,27305,1,44,27285,6945
22,20,27285,27305,-1,44,27305,15137
22,152,27305,27457,1,187,27305,6946
22,152,27305,27457,-1,187,27457,15138
22,73,27457,27530,1,40,27457,6947
22,73,27457,27530,-1,40,27530,15139
22,258,27530,27788,1,225,27530,6948
22,258,27530,27788,-1,225,27788,15140
22,161,27788,27949,1,208,27788,6949
22,161,27788,27949,-1,208,27949,15141
22,54,27949,28003,1,251,27949,6950
22,54,27949,28003,-1,251,28003,15142
22,186,28003,28189,1,63,28003,6951
22,186,28003,28189,-1,63,28189,15143
22,102,28189,28291,1,49,28189,6952
22,102,28189,28291,-1,49,28291,15144
22,69,28291,28360,1,212,28291,6953
22,69,28291,28360,-1,212,28360,15145
22,150,28360,28510,1,136,28360,6954
22,150,28360,28510,-1,136,28510,15146
22,106,28510,28616,1,84,28510,6955
22,106,28510,28616,-1,84,28616,15147
22,36,28616,28652,1,64,28616,6956
22,36,28616,28652,-1,64,28652,15148
22,292,28652,28944,1,116,28652,6957
22,292,28652,28944,-1,116,28944,15149
22,190,28944,29134,1,150,28944,6958
22,190,28944,29134,-1,150,29134,15150
22,247,29134,29381,1,252,29134,6959
22,247,29134,29381,-1,252,29381,15151
22,189,29381,29570,1,223,29381,6960
22,189,29381,29570,-1,223,29570,15152
22,88,29570,29658,1,210,29570,6961
22,88,29570,29658,-1,210,29658,15153
22,165,29658,29823,1,188,29658,6962
22,165,29658,29823,-1,188,29823,15154
22,179,29823,30002,1,135,29823,6963
22,179,29823,30002,-1,135,30002,15155
22,166,30002,30168,1,216,30002,6964
22,166,30002,30168,-1,216,30168,15156
22,132,30168,30300,1,182,30168,6965
22,132,30168,30300,-1,182,30300,15157
22,39,30300,30339,1,178,30300,6966
22,39,30300,30339,-1,178,30339,15158
22,121,30339,30460,1,185,30339,6967
22,121,30339,30460,-1,185,30460,15159
22,146,30460,30606,1,163,30460,6968
22,146,30460,30606,-1,163,30606,15160
22,131,30606,30737,1,183,30606,6969
22,131,30606,30737,-1,183,30737,15161
22,92,30737,30829,1,206,30737,6970
22,92,30737,30829,-1,206,30829,15162
22,37,30829,30866,1,184,30829,6971
22,37,30829,30866,-1,184,30866,15163
22,140,30866,31006,1,148,30866,6972
22,140,30866,31006,-1,148,31006,15164
22,152,31006,31158,1,34,31006,6973
22,152,31006,31158,-1,34,31158,15165
22,136,31158,31294,1,107,31158,6974
22,136,31158,31294,-1,107,31294,15166
23,255,0,255,1,146,0,6975
23,255,0,255,-1,146,255,15167
23,65,255,320,1,161,255,6976
23,65,255,320,-1,161,320,15168
23,90,320,410,1,182,320,6977
23,90,320,410,-1,182,410,15169
23,67,410,477,1,222,410,6978
23,67,410,477,-1,222,477,15170
23,79,477,556,1,73,477,6979
23,79,477,556,-1,73,556,15171
23,50,556,606,1,167,556,6980
23,50,556,606,-1,167,606,15172
23,53,606,659,1,108,606,6981
23,53,606,659,-1,108,659,15173
23,104,659,763,1,185,659,6982
23,104,659,763,-1,185,763,15174
23,155,763,918,1,155,763,6983
23,155,763,918,-1,155,918,15175
23,182,918,1100,1,113,918,6984
23,182,918,1100,-1,113,1100,15176
23,159,1100,1259,1,97,1100,6985
23,159,1100,1259,-1,97,1259,15177
23,129,1259,1388,1,21,1259,6986
23,129,1259,1388,-1,21,1388,15178
23,118,1388,1506,1,218,1388,6987
23,118,1388,1506,-1,218,1506,15179
23,60,1506,1566,1,46,1506,6988
23,60,1506,1566,-1,46,1566,15180
23,159,1566,1725,1,220,1566,6989
23,159,1566,1725,-1,220,1725,15181
23,241,1725,1966,1,110,1725,6990
23,241,1725,1966,-1,110,1966,15182
23,167,1966,2133,1,37,1966,6991
23,167,1966,2133,-1,37,2133,15183
23,76,2133,2209,1,186,2133,6992
23,76,2133,2209,-1,186,2209,15184
23,157,2209,2366,1,79,2209,6993
23,157,2209,2366,-1,79,2366,15185
23,138,2366,2504,1,2,2366,6994
23,138,2366,2504,-1,2,2504,15186
23,170,2504,2674,1,233,2504,6995
23,170,2504,2674,-1,233,2674,15187
23,72,2674,2746,1,86,2674,6996
23,72,2674,2746,-1,86,2746,15188
23,91,2746,2837,1,123,2746,6997
23,91,2746,2837,-1,123,2837,15189
23,86,2837,2923,1,19,2837,6998
23,86,2837,2923,-1,19,2923,15190
23,106,2923,3029,1,102,2923,6999
23,106,2923,3029,-1,102,3029,15191
23,210,3029,3239,1,195,3029,7000
23,210,3029,3239,-1,195,3239,15192
23,98,3239,3337,1,125,3239,7001
23,98,3239,3337,-1,125,3337,15193
23,90,3337,3427,1,116,3337,7002
23,90,3337,3427,-1,116,3427,15194
23,78,3427,3505,1,119,3427,7003
23,78,3427,3505,-1,119,3505,15195
23,89,3505,3594,1,147,3505,7004
23,89,3505,3594,-1,147,3594,15196
23,214,3594,3808,1,27,3594,7005
23,214,3594,3808,-1,27,3808,15197
23,84,3808,3892,1,242,3808,7006
23,84,3808,3892,-1,242,3892,15198
23,83,3892,3975,1,22,3892,7007
23,83,3892,3975,-1,22,3975,15199
23,90,3975,4065,1,99,3975,7008
23,90,3975,4065,-1,99,4065,15200
23,146,4065,4211,1,256,4065,7009
23,146,4065,4211,-1,256,4211,15201
23,51,4211,4262,1,150,4211,7010
23,51,4211,4262,-1,150,4262,15202
23,88,4262,4350,1,10,4262,7011
23,88,4262,4350,-1,10,4350,15203
23,42,4350,4392,1,107,4350,7012
23,42,4350,4392,-1,107,4392,15204
23,105,4392,4497,1,80,4392,7013
23,105,4392,4497,-1,80,4497,15205
23,161,4497,4658,1,126,4497,7014
23,161,4497,4658,-1,126,4658,15206
23,113,4658,4771,1,243,4658,7015
23,113,4658,4771,-1,243,4771,15207
23,129,4771,4900,1,221,4771,7016
23,129,4771,4900,-1,221,4900,15208
23,145,4900,5045,1,41,4900,7017
23,145,4900,5045,-1,41,5045,15209
23,67,5045,5112,1,1,5045,7018
23,67,5045,5112,-1,1,5112,15210
23,24,5112,5136,1,191,5112,7019
23,24,5112,5136,-1,191,5136,15211
23,125,5136,5261,1,199,5136,7020
23,125,5136,5261,-1,199,5261,15212
23,43,5261,5304,1,109,5261,7021
23,43,5261,5304,-1,109,5304,15213
23,183,5304,5487,1,81,5304,7022
23,183,5304,5487,-1,81,5487,15214
23,192,5487,5679,1,10,5487,7023
23,192,5487,5679,-1,10,5679,15215
23,237,5679,5916,1,19,5679,7024
23,237,5679,5916,-1,19,5916,15216
23,117,5916,6033,1,89,5916,7025
23,117,5916,6033,-1,89,6033,15217
23,187,6033,6220,1,242,6033,7026
23,187,6033,6220,-1,242,6220,15218
23,230,6220,6450,1,60,6220,7027
23,230,6220,6450,-1,60,6450,15219
23,216,6450,6666,1,92,6450,7028
23,216,6450,6666,-1,92,6666,15220
23,50,6666,6716,1,199,6666,7029
23,50,6666,6716,-1,199,6716,15221
23,146,6716,6862,1,110,6716,7030
23,146,6716,6862,-1,110,6862,15222
23,167,6862,7029,1,163,6862,7031
23,167,6862,7029,-1,163,7029,15223
23,227,7029,7256,1,6,7029,7032
23,227,7029,7256,-1,6,7256,15224
23,104,7256,7360,1,117,7256,7033
23,104,7256,7360,-1,117,7360,15225
23,64,7360,7424,1,222,7360,7034
23,64,7360,7424,-1,222,7424,15226
23,175,7424,7599,1,42,7424,7035
23,175,7424,7599,-1,42,7599,15227
23,202,7599,7801,1,233,7599,7036
23,202,7599,7801,-1,233,7801,15228
23,212,7801,8013,1,181,7801,7037
23,212,7801,8013,-1,181,8013,15229
23,68,8013,8081,1,92,8013,7038
23,68,8013,8081,-1,92,8081,15230
23,181,8081,8262,1,252,8081,7039
23,181,8081,8262,-1,252,8262,15231
23,119,8262,8381,1,188,8262,7040
23,119,8262,8381,-1,188,8381,15232
23,166,8381,8547,1,107,8381,7041
23,166,8381,8547,-1,107,8547,15233
23,63,8547,8610,1,200,8547,7042
23,63,8547,8610,-1,200,8610,15234
23,124,8610,8734,1,61,8610,7043
23,124,8610,8734,-1,61,8734,15235
23,175,8734,8909,1,202,8734,7044
23,175,8734,8909,-1,202,8909,15236
23,189,8909,9098,1,144,8909,7045
23,189,8909,9098,-1,144,9098,15237
23,203,9098,9301,1,60,9098,7046
23,203,9098,9301,-1,60,9301,15238
23,106,9301,9407,1,139,9301,7047
23,106,9301,9407,-1,139,9407,15239
23,121,9407,9528,1,211,9407,7048
23,121,9407,9528,-1,211,9528,15240
23,141,9528,9669,1,1,9528,7049
23,141,9528,9669,-1,1,9669,15241
23,120,9669,9789,1,26,9669,7050
23,120,9669,9789,-1,26,9789,15242
23,101,9789,9890,1,247,9789,7051
23,101,9789,9890,-1,247,9890,15243
23,88,9890,9978,1,243,9890,7052
23,88,9890,9978,-1,243,9978,15244
23,86,9978,10064,1,232,9978,7053
23,86,9978,10064,-1,232,10064,15245
23,142,10064,10206,1,68,10064,7054
23,142,10064,10206,-1,68,10206,15246
23,83,10206,10289,1,93,10206,7055
23,83,10206,10289,-1,93,10289,15247
23,129,10289,10418,1,26,10289,7056
23,129,10289,10418,-1,26,10418,15248
23,178,10418,10596,1,162,10418,7057
23,178,10418,10596,-1,162,10596,15249
23,121,10596,10717,1,68,10596,7058
23,121,10596,10717,-1,68,10717,15250
23,155,10717,10872,1,216,10717,7059
23,155,10717,10872,-1,216,10872,15251
23,196,10872,11068,1,150,10872,7060
23,196,10872,11068,-1,150,11068,15252
23,87,11068,11155,1,161,11068,7061
23,87,11068,11155,-1,161,11155,15253
23,159,11155,11314,1,213,11155,7062
23,159,11155,11314,-1,213,11314,15254
23,53,11314,11367,1,236,11314,7063
23,53,11314,11367,-1,236,11367,15255
23,75,11367,11442,1,50,11367,7064
23,75,11367,11442,-1,50,11442,15256
23,199,11442,11641,1,111,11442,7065
23,199,11442,11641,-1,111,11641,15257
23,125,11641,11766,1,198,11641,7066
23,125,11641,11766,-1,198,11766,15258
23,168,11766,11934,1,55,11766,7067
23,168,11766,11934,-1,55,11934,15259
23,103,11934,12037,1,21,11934,7068
23,103,11934,12037,-1,21,12037,15260
23,38,12037,12075,1,205,12037,7069
23,38,12037,12075,-1,205,12075,15261
23,107,12075,12182,1,76,12075,7070
23,107,12075,12182,-1,76,12182,15262
23,51,12182,12233,1,188,12182,7071
23,51,12182,12233,-1,188,12233,15263
23,263,12233,12496,1,4,12233,7072
23,263,12233,12496,-1,4,12496,15264
23,205,12496,12701,1,122,12496,7073
23,205,12496,12701,-1,122,12701,15265
23,107,12701,12808,1,169,12701,7074
23,107,12701,12808,-1,169,12808,15266
23,62,12808,12870,1,248,12808,7075
23,62,12808,12870,-1,248,12870,15267
23,131,12870,13001,1,113,12870,7076
23,131,12870,13001,-1,113,13001,15268
23,245,13001,13246,1,152,13001,7077
23,245,13001,13246,-1,152,13246,15269
23,54,13246,13300,1,153,13246,7078
23,54,13246,13300,-1,153,13300,15270
23,93,13300,13393,1,62,13300,7079
23,93,13300,13393,-1,62,13393,15271
23,140,13393,13533,1,209,13393,7080
23,140,13393,13533,-1,209,13533,15272
23,155,13533,13688,1,29,13533,7081
23,155,13533,13688,-1,29,13688,15273
23,112,13688,13800,1,148,13688,7082
23,112,13688,13800,-1,148,13800,15274
23,210,13800,14010,1,59,13800,7083
23,210,13800,14010,-1,59,14010,15275
23,127,14010,14137,1,223,14010,7084
23,127,14010,14137,-1,223,14137,15276
23,123,14137,14260,1,216,14137,7085
23,123,14137,14260,-1,216,14260,15277
23,188,14260,14448,1,47,14260,7086
23,188,14260,14448,-1,47,14448,15278
23,164,14448,14612,1,28,14448,7087
23,164,14448,14612,-1,28,14612,15279
23,67,14612,14679,1,66,14612,7088
23,67,14612,14679,-1,66,14679,15280
23,108,14679,14787,1,194,14679,7089
23,108,14679,14787,-1,194,14787,15281
23,71,14787,14858,1,227,14787,7090
23,71,14787,14858,-1,227,14858,15282
23,147,14858,15005,1,15,14858,7091
23,147,14858,15005,-1,15,15005,15283
23,141,15005,15146,1,212,15005,7092
23,141,15005,15146,-1,212,15146,15284
23,55,15146,15201,1,150,15146,7093
23,55,15146,15201,-1,150,15201,15285
23,99,15201,15300,1,227,15201,7094
23,99,15201,15300,-1,227,15300,15286
23,178,15300,15478,1,195,15300,7095
23,178,15300,15478,-1,195,15478,15287
23,76,15478,15554,1,66,15478,7096
23,76,15478,15554,-1,66,15554,15288
23,54,15554,15608,1,116,15554,7097
23,54,15554,15608,-1,116,15608,15289
23,63,15608,15671,1,153,15608,7098
23,63,15608,15671,-1,153,15671,15290
23,119,15671,15790,1,159,15671,7099
23,119,15671,15790,-1,159,15790,15291
23,257,15790,16047,1,17,15790,7100
23,257,15790,16047,-1,17,16047,15292
23,79,16047,16126,1,30,16047,7101
23,79,16047,16126,-1,30,16126,15293
23,35,16126,16161,1,171,16126,7102
23,35,16126,16161,-1,171,16161,15294
23,196,16161,16357,1,116,16161,7103
23,196,16161,16357,-1,116,16357,15295
23,75,16357,16432,1,211,16357,7104
23,75,16357,16432,-1,211,16432,15296
23,125,16432,16557,1,34,16432,7105
23,125,16432,16557,-1,34,16557,15297
23,93,16557,16650,1,101,16557,7106
23,93,16557,16650,-1,101,16650,15298
23,111,16650,16761,1,13,16650,7107
23,111,16650,16761,-1,13,16761,15299
23,166,16761,16927,1,97,16761,7108
23,166,16761,16927,-1,97,16927,15300
23,70,16927,16997,1,23,16927,7109
23,70,16927,16997,-1,23,16997,15301
23,286,16997,17283,1,183,16997,7110
23,286,16997,17283,-1,183,17283,15302
23,83,17283,17366,1,147,17283,7111
23,83,17283,17366,-1,147,17366,15303
23,61,17366,17427,1,254,17366,7112
23,61,17366,17427,-1,254,17427,15304
23,235,17427,17662,1,60,17427,7113
23,235,17427,17662,-1,60,17662,15305
23,144,17662,17806,1,3,17662,7114
23,144,17662,17806,-1,3,17806,15306
23,148,17806,17954,1,17,17806,7115
23,148,17806,17954,-1,17,17954,15307
23,99,17954,18053,1,46,17954,7116
23,99,17954,18053,-1,46,18053,15308
23,93,18053,18146,1,51,18053,7117
23,93,18053,18146,-1,51,18146,15309
23,44,18146,18190,1,36,18146,7118
23,44,18146,18190,-1,36,18190,15310
23,104,18190,18294,1,41,18190,7119
23,104,18190,18294,-1,41,18294,15311
23,63,18294,18357,1,190,18294,7120
23,63,18294,18357,-1,190,18357,15312
23,86,18357,18443,1,18,18357,7121
23,86,18357,18443,-1,18,18443,15313
23,118,18443,18561,1,117,18443,7122
23,118,18443,18561,-1,117,18561,15314
23,159,18561,18720,1,93,18561,7123
23,159,18561,18720,-1,93,18720,15315
23,114,18720,18834,1,164,18720,7124
23,114,18720,18834,-1,164,18834,15316
23,67,18834,18901,1,55,18834,7125
23,67,18834,18901,-1,55,18901,15317
23,97,18901,18998,1,92,18901,7126
23,97,18901,18998,-1,92,18998,15318
23,213,18998,19211,1,233,18998,7127
23,213,18998,19211,-1,233,19211,15319
23,263,19211,19474,1,230,19211,7128
23,263,19211,19474,-1,230,19474,15320
23,124,19474,19598,1,15,19474,7129
23,124,19474,19598,-1,15,19598,15321
23,102,19598,19700,1,248,19598,7130
23,102,19598,19700,-1,248,19700,15322
23,61,19700,19761,1,52,19700,7131
23,61,19700,19761,-1,52,19761,15323
23,106,19761,19867,1,247,19761,7132
23,106,19761,19867,-1,247,19867,15324
23,134,19867,20001,1,43,19867,7133
23,134,19867,20001,-1,43,20001,15325
23,82,20001,20083,1,188,20001,7134
23,82,20001,20083,-1,188,20083,15326
23,84,20083,20167,1,53,20083,7135
23,84,20083,20167,-1,53,20167,15327
23,99,20167,20266,1,133,20167,7136
23,99,20167,20266,-1,133,20266,15328
23,117,20266,20383,1,219,20266,7137
23,117,20266,20383,-1,219,20383,15329
23,190,20383,20573,1,225,20383,7138
23,190,20383,20573,-1,225,20573,15330
23,129,20573,20702,1,108,20573,7139
23,129,20573,20702,-1,108,20702,15331
23,224,20702,20926,1,161,20702,7140
23,224,20702,20926,-1,161,20926,15332
23,207,20926,21133,1,206,20926,7141
23,207,20926,21133,-1,206,21133,15333
23,85,21133,21218,1,238,21133,7142
23,85,21133,21218,-1,238,21218,15334
23,65,21218,21283,1,181,21218,7143
23,65,21218,21283,-1,181,21283,15335
23,119,21283,21402,1,233,21283,7144
23,119,21283,21402,-1,233,21402,15336
23,95,21402,21497,1,143,21402,7145
23,95,21402,21497,-1,143,21497,15337
23,17,21497,21514,1,120,21497,7146
23,17,21497,21514,-1,120,21514,15338
23,136,21514,21650,1,210,21514,7147
23,136,21514,21650,-1,210,21650,15339
23,88,21650,21738,1,146,21650,7148
23,88,21650,21738,-1,146,21738,15340
23,211,21738,21949,1,31,21738,7149
23,211,21738,21949,-1,31,21949,15341
23,112,21949,22061,1,251,21949,7150
23,112,21949,22061,-1,251,22061,15342
23,70,22061,22131,1,36,22061,7151
23,70,22061,22131,-1,36,22131,15343
23,106,22131,22237,1,49,22131,7152
23,106,22131,22237,-1,49,22237,15344
23,122,22237,22359,1,17,22237,7153
23,122,22237,22359,-1,17,22359,15345
23,141,22359,22500,1,16,22359,7154
23,141,22359,22500,-1,16,22500,15346
23,91,22500,22591,1,213,22500,7155
23,91,22500,22591,-1,213,22591,15347
23,114,22591,22705,1,77,22591,7156
23,114,22591,22705,-1,77,22705,15348
23,173,22705,22878,1,58,22705,7157
23,173,22705,22878,-1,58,22878,15349
23,108,22878,22986,1,183,22878,7158
23,108,22878,22986,-1,183,22986,15350
23,156,22986,23142,1,119,22986,7159
23,156,22986,23142,-1,119,23142,15351
23,84,23142,23226,1,161,23142,7160
23,84,23142,23226,-1,161,23226,15352
23,81,23226,23307,1,210,23226,7161
23,81,23226,23307,-1,210,23307,15353
23,115,23307,23422,1,42,23307,7162
23,115,23307,23422,-1,42,23422,15354
23,175,23422,23597,1,127,23422,7163
23,175,23422,23597,-1,127,23597,15355
23,129,23597,23726,1,29,23597,7164
23,129,23597,23726,-1,29,23726,15356
23,37,23726,23763,1,61,23726,7165
23,37,23726,23763,-1,61,23763,15357
23,217,23763,23980,1,154,23763,7166
23,217,23763,23980,-1,154,23980,15358
23,97,23980,24077,1,226,23980,7167
23,97,23980,24077,-1,226,24077,15359
23,50,24077,24127,1,100,24077,7168
23,50,24077,24127,-1,100,24127,15360
23,159,24127,24286,1,225,24127,7169
23,159,24127,24286,-1,225,24286,15361
23,227,24286,24513,1,21,24286,7170
23,227,24286,24513,-1,21,24513,15362
23,72,24513,24585,1,142,24513,7171
23,72,24513,24585,-1,142,24585,15363
23,55,24585,24640,1,234,24585,7172
23,55,24585,24640,-1,234,24640,15364
23,124,24640,24764,1,231,24640,7173
23,124,24640,24764,-1,231,24764,15365
23,59,24764,24823,1,38,24764,7174
23,59,24764,24823,-1,38,24823,15366
23,91,24823,24914,1,223,24823,7175
23,91,24823,24914,-1,223,24914,15367
23,110,24914,25024,1,91,24914,7176
23,110,24914,25024,-1,91,25024,15368
23,102,25024,25126,1,218,25024,7177
23,102,25024,25126,-1,218,25126,15369
23,122,25126,25248,1,204,25126,7178
23,122,25126,25248,-1,204,25248,15370
23,87,25248,25335,1,134,25248,7179
23,87,25248,25335,-1,134,25335,15371
23,133,25335,25468,1,113,25335,7180
23,133,25335,25468,-1,113,25468,15372
23,21,25468,25489,1,206,25468,7181
23,21,25468,25489,-1,206,25489,15373
23,68,25489,25557,1,15,25489,7182
23,68,25489,25557,-1,15,25557,15374
23,229,25557,25786,1,167,25557,7183
23,229,25557,25786,-1,167,25786,15375
23,56,25786,25842,1,188,25786,7184
23,56,25786,25842,-1,188,25842,15376
23,104,25842,25946,1,195,25842,7185
23,104,25842,25946,-1,195,25946,15377
23,139,25946,26085,1,85,25946,7186
23,139,25946,26085,-1,85,26085,15378
23,205,26085,26290,1,67,26085,7187
23,205,26085,26290,-1,67,26290,15379
23,232,26290,26522,1,1,26290,7188
23,232,26290,26522,-1,1,26522,15380
23,230,26522,26752,1,29,26522,7189
23,230,26522,26752,-1,29,26752,15381
23,114,26752,26866,1,16,26752,7190
23,114,26752,26866,-1,16,26866,15382
23,175,26866,27041,1,61,26866,7191
23,175,26866,27041,-1,61,27041,15383
23,116,27041,27157,1,1,27041,7192
23,116,27041,27157,-1,1,27157,15384
23,57,27157,27214,1,216,27157,7193
23,57,27157,27214,-1,216,27214,15385
23,187,27214,27401,1,79,27214,7194
23,187,27214,27401,-1,79,27401,15386
23,180,27401,27581,1,205,27401,7195
23,180,27401,27581,-1,205,27581,15387
23,39,27581,27620,1,213,27581,7196
23,39,27581,27620,-1,213,27620,15388
23,107,27620,27727,1,252,27620,7197
23,107,27620,27727,-1,252,27727,15389
23,100,27727,27827,1,144,27727,7198
23,100,27727,27827,-1,144,27827,15390
23,119,27827,27946,1,9,27827,7199
23,119,27827,27946,-1,9,27946,15391
23,162,27946,28108,1,48,27946,7200
23,162,27946,28108,-1,48,28108,15392
23,207,28108,28315,1,35,28108,7201
23,207,28108,28315,-1,35,28315,15393
23,98,28315,28413,1,172,28315,7202
23,98,28315,28413,-1,172,28413,15394
23,118,28413,28531,1,83,28413,7203
23,118,28413,28531,-1,83,28531,15395
24,94,0,94,1,255,0,7704
24,94,0,94,-1,255,94,15896
24,126,94,220,1,1,94,7705
24,126,94,220,-1,1,220,15897
24,81,220,301,1,176,220,7706
24,81,220,301,-1,176,301,15898
24,62,301,363,1,126,301,7707
24,62,301,363,-1,126,363,15899
24,83,363,446,1,104,363,7708
24,83,363,446,-1,104,446,15900
24,165,446,611,1,177,446,7709
24,165,446,611,-1,177,611,15901
24,239,611,850,1,49,611,7710
24,239,611,850,-1,49,850,15902
24,82,850,932,1,249,850,7711
24,82,850,932,-1,249,932,15903
24,165,932,1097,1,222,932,7712
24,165,932,1097,-1,222,1097,15904
24,71,1097,1168,1,66,1097,7713
24,71,1097,1168,-1,66,1168,15905
24,214,1168,1382,1,152,1168,7714
24,214,1168,1382,-1,152,1382,15906
24,140,1382,1522,1,89,1382,7715
24,140,1382,1522,-1,89,1522,15907
24,83,1522,1605,1,174,1522,7716
24,83,1522,1605,-1,174,1605,15908
24,64,1605,1669,1,87,1605,7717
24,64,1605,1669,-1,87,1669,15909
24,155,1669,1824,1,183,1669,7718
24,155,1669,1824,-1,183,1824,15910
24,42,1824,1866,1,31,1824,7719
24,42,1824,1866,-1,31,1866,15911
24,105,1866,1971,1,80,1866,7720
24,105,1866,1971,-1,80,1971,15912
24,112,1971,2083,1,148,1971,7721
24,112,1971,2083,-1,148,2083,15913
24,97,2083,2180,1,140,2083,7722
24,97,2083,2180,-1,140,2180,15914
24,123,2180,2303,1,151,2180,7723
24,123,2180,2303,-1,151,2303,15915
24,120,2303,2423,1,95,2303,7724
24,120,2303,2423,-1,95,2423,15916
24,90,2423,2513,1,169,2423,7725
24,90,2423,2513,-1,169,2513,15917
24,83,2513,2596,1,243,2513,7726
24,83,2513,2596,-1,243,2596,15918
24,155,2596,2751,1,11,2596,7727
24,155,2596,2751,-1,11,2751,15919
24,44,2751,2795,1,141,2751,7728
24,44,2751,2795,-1,141,2795,15920
24,85,2795,2880,1,26,2795,7729
24,85,2795,2880,-1,26,2880,15921
24,30,2880,2910,1,245,2880,7730
24,30,2880,2910,-1,245,2910,15922
24,193,2910,3103,1,117,2910,7731
24,193,2910,3103,-1,117,3103,15923
24,48,3103,3151,1,172,3103,7732
24,48,3103,3151,-1,172,3151,15924
24,34,3151,3185,1,239,3151,7733
24,34,3151,3185,-1,239,3185,15925
24,99,3185,3284,1,117,3185,7734
24,99,3185,3284,-1,117,3284,15926
24,176,3284,3460,1,45,3284,7735
24,176,3284,3460,-1,45,3460,15927
24,107,3460,3567,1,178,3460,7736
24,107,3460,3567,-1,178,3567,15928
24,58,3567,3625,1,108,3567,7737
24,58,3567,3625,-1,108,3625,15929
24,171,3625,3796,1,196,3625,7738
24,171,3625,3796,-1,196,3796,15930
24,132,3796,3928,1,211,3796,7739
24,132,3796,3928,-1,211,3928,15931
24,132,3928,4060,1,8,3928,7740
24,132,3928,4060,-1,8,4060,15932
24,174,4060,4234,1,95,4060,7741
24,174,4060,4234,-1,95,4234,15933
24,209,4234,4443,1,170,4234,7742
24,209,4234,4443,-1,170,4443,15934
24,60,4443,4503,1,195,4443,7743
24,60,4443,4503,-1,195,4503,15935
24,232,4503,4735,1,255,4503,7744
24,232,4503,4735,-1,255,4735,15936
24,115,4735,4850,1,232,4735,7745
24,115,4735,4850,-1,232,4850,15937
24,61,4850,4911,1,168,4850,7746
24,61,4850,4911,-1,168,4911,15938
24,150,4911,5061,1,28,4911,7747
24,150,4911,5061,-1,28,5061,15939
24,285,5061,5346,1,159,5061,7748
24,285,5061,5346,-1,159,5346,15940
24,114,5346,5460,1,120,5346,7749
24,114,5346,5460,-1,120,5460,15941
24,242,5460,5702,1,118,5460,7750
24,242,5460,5702,-1,118,5702,15942
24,151,5702,5853,1,58,5702,7751
24,151,5702,5853,-1,58,5853,15943
24,130,5853,5983,1,179,5853,7752
24,130,5853,5983,-1,179,5983,15944
24,86,5983,6069,1,247,5983,7753
24,86,5983,6069,-1,247,6069,15945
24,92,6069,6161,1,111,6069,7754
24,92,6069,6161,-1,111,6161,15946
24,200,6161,6361,1,215,6161,7755
24,200,6161,6361,-1,215,6361,15947
24,65,6361,6426,1,251,6361,7756
24,65,6361,6426,-1,251,6426,15948
24,209,6426,6635,1,113,6426,7757
24,209,6426,6635,-1,113,6635,15949
24,105,6635,6740,1,207,6635,7758
24,105,6635,6740,-1,207,6740,15950
24,218,6740,6958,1,225,6740,7759
24,218,6740,6958,-1,225,6958,15951
24,55,6958,7013,1,46,6958,7760
24,55,6958,7013,-1,46,7013,15952
24,151,7013,7164,1,182,7013,7761
24,151,7013,7164,-1,182,7164,15953
24,183,7164,7347,1,117,7164,7762
24,183,7164,7347,-1,117,7347,15954
24,29,7347,7376,1,245,7347,7763
24,29,7347,7376,-1,245,7376,15955
24,57,7376,7433,1,42,7376,7764
24,57,7376,7433,-1,42,7433,15956
24,214,7433,7647,1,175,7433,7765
24,214,7433,7647,-1,175,7647,15957
24,148,7647,7795,1,188,7647,7766
24,148,7647,7795,-1,188,7795,15958
24,201,7795,7996,1,4,7795,7767
24,201,7795,7996,-1,4,7996,15959
24,168,7996,8164,1,232,7996,7768
24,168,7996,8164,-1,232,8164,15960
24,163,8164,8327,1,215,8164,7769
24,163,8164,8327,-1,215,8327,15961
24,73,8327,8400,1,113,8327,7770
24,73,8327,8400,-1,113,8400,15962
24,69,8400,8469,1,72,8400,7771
24,69,8400,8469,-1,72,8469,15963
24,183,8469,8652,1,64,8469,7772
24,183,8469,8652,-1,64,8652,15964
24,99,8652,8751,1,123,8652,7773
24,99,8652,8751,-1,123,8751,15965
24,505,8751,9256,1,63,8751,7774
24,505,8751,9256,-1,63,9256,15966
24,176,9256,9432,1,238,9256,7775
24,176,9256,9432,-1,238,9432,15967
24,93,9432,9525,1,74,9432,7776
24,93,9432,9525,-1,74,9525,15968
24,99,9525,9624,1,19,9525,7777
24,99,9525,9624,-1,19,9624,15969
24,180,9624,9804,1,168,9624,7778
24,180,9624,9804,-1,168,9804,15970
24,122,9804,9926,1,74,9804,7779
24,122,9804,9926,-1,74,9926,15971
24,121,9926,10047,1,59,9926,7780
24,121,9926,10047,-1,59,10047,15972
24,187,10047,10234,1,229,10047,7781
24,187,10047,10234,-1,229,10234,15973
24,85,10234,10319,1,79,10234,7782
24,85,10234,10319,-1,79,10319,15974
24,118,10319,10437,1,172,10319,7783
24,118,10319,10437,-1,172,10437,15975
24,52,10437,10489,1,61,10437,7784
24,52,10437,10489,-1,61,10489,15976
24,118,10489,10607,1,211,10489,7785
24,118,10489,10607,-1,211,10607,15977
24,171,10607,10778,1,113,10607,7786
24,171,10607,10778,-1,113,10778,15978
24,157,10778,10935,1,155,10778,7787
24,157,10778,10935,-1,155,10935,15979
24,45,10935,10980,1,189,10935,7788
24,45,10935,10980,-1,189,10980,15980
24,23,10980,11003,1,152,10980,7789
24,23,10980,11003,-1,152,11003,15981
24,135,11003,11138,1,189,11003,7790
24,135,11003,11138,-1,189,11138,15982
24,194,11138,11332,1,231,11138,7791
24,194,11138,11332,-1,231,11332,15983
24,116,11332,11448,1,20,11332,7792
24,116,11332,11448,-1,20,11448,15984
24,143,11448,11591,1,49,11448,7793
24,143,11448,11591,-1,49,11591,15985
24,143,11591,11734,1,180,11591,7794
24,143,11591,11734,-1,180,11734,15986
24,130,11734,11864,1,150,11734,7795
24,130,11734,11864,-1,150,11864,15987
24,155,11864,12019,1,125,11864,7796
24,155,11864,12019,-1,125,12019,15988
24,170,12019,12189,1,14,12019,7797
24,170,12019,12189,-1,14,12189,15989
24,97,12189,12286,1,202,12189,7798
24,97,12189,12286,-1,202,12286,15990
24,22,12286,12308,1,27,12286,7799
24,22,12286,12308,-1,27,12308,15991
24,73,12308,12381,1,210,12308,7800
24,73,12308,12381,-1,210,12381,15992
24,183,12381,12564,1,7,12381,7801
24,183,12381,12564,-1,7,12564,15993
24,118,12564,12682,1,180,12564,7802
24,118,12564,12682,-1,180,12682,15994
24,59,12682,12741,1,221,12682,7803
24,59,12682,12741,-1,221,12741,15995
24,101,12741,12842,1,87,12741,7804
24,101,12741,12842,-1,87,12842,15996
24,117,12842,12959,1,18,12842,7805
24,117,12842,12959,-1,18,12959,15997
24,154,12959,13113,1,103,12959,7806
24,154,12959,13113,-1,103,13113,15998
24,50,13113,13163,1,238,13113,7807
24,50,13113,13163,-1,238,13163,15999
24,65,13163,13228,1,78,13163,7808
24,65,13163,13228,-1,78,13228,16000
24,120,13228,13348,1,87,13228,7809
24,120,13228,13348,-1,87,13348,16001
24,193,13348,13541,1,107,13348,7810
24,193,13348,13541,-1,107,13541,16002
24,83,13541,13624,1,67,13541,7811
24,83,13541,13624,-1,67,13624,16003
24,294,13624,13918,1,82,13624,7812
24,294,13624,13918,-1,82,13918,16004
24,253,13918,14171,1,97,13918,7813
24,253,13918,14171,-1,97,14171,16005
24,146,14171,14317,1,89,14171,7814
24,146,14171,14317,-1,89,14317,16006
24,109,14317,14426,1,254,14317,7815
24,109,14317,14426,-1,254,14426,16007
24,168,14426,14594,1,187,14426,7816
24,168,14426,14594,-1,187,14594,16008
24,149,14594,14743,1,138,14594,7817
24,149,14594,14743,-1,138,14743,16009
24,95,14743,14838,1,106,14743,7818
24,95,14743,14838,-1,106,14838,16010
24,173,14838,15011,1,157,14838,7819
24,173,14838,15011,-1,157,15011,16011
24,228,15011,15239,1,14,15011,7820
24,228,15011,15239,-1,14,15239,16012
24,228,15239,15467,1,218,15239,7821
24,228,15239,15467,-1,218,15467,16013
24,146,15467,15613,1,164,15467,7822
24,146,15467,15613,-1,164,15613,16014
24,100,15613,15713,1,204,15613,7823
24,100,15613,15713,-1,204,15713,16015
24,181,15713,15894,1,238,15713,7824
24,181,15713,15894,-1,238,15894,16016
24,101,15894,15995,1,9,15894,7825
24,101,15894,15995,-1,9,15995,16017
24,99,15995,16094,1,236,15995,7826
24,99,15995,16094,-1,236,16094,16018
24,206,16094,16300,1,125,16094,7827
24,206,16094,16300,-1,125,16300,16019
24,122,16300,16422,1,110,16300,7828
24,122,16300,16422,-1,110,16422,16020
24,147,16422,16569,1,100,16422,7829
24,147,16422,16569,-1,100,16569,16021
24,47,16569,16616,1,245,16569,7830
24,47,16569,16616,-1,245,16616,16022
24,76,16616,16692,1,1,16616,7831
24,76,16616,16692,-1,1,16692,16023
24,122,16692,16814,1,224,16692,7832
24,122,16692,16814,-1,224,16814,16024
24,115,16814,16929,1,129,16814,7833
24,115,16814,16929,-1,129,16929,16025
24,46,16929,16975,1,143,16929,7834
24,46,16929,16975,-1,143,16975,16026
24,122,16975,17097,1,20,16975,7835
24,122,16975,17097,-1,20,17097,16027
24,85,17097,17182,1,208,17097,7836
24,85,17097,17182,-1,208,17182,16028
24,161,17182,17343,1,191,17182,7837
24,161,17182,17343,-1,191,17343,16029
24,71,17343,17414,1,160,17343,7838
24,71,17343,17414,-1,160,17414,16030
24,121,17414,17535,1,170,17414,7839
24,121,17414,17535,-1,170,17535,16031
24,93,17535,17628,1,135,17535,7840
24,93,17535,17628,-1,135,17628,16032
24,246,17628,17874,1,90,17628,7841
24,246,17628,17874,-1,90,17874,16033
24,161,17874,18035,1,255,17874,7842
24,161,17874,18035,-1,255,18035,16034
24,230,18035,18265,1,67,18035,7843
24,230,18035,18265,-1,67,18265,16035
24,103,18265,18368,1,171,18265,7844
24,103,18265,18368,-1,171,18368,16036
24,147,18368,18515,1,49,18368,7845
24,147,18368,18515,-1,49,18515,16037
24,341,18515,18856,1,140,18515,7846
24,341,18515,18856,-1,140,18856,16038
24,68,18856,18924,1,94,18856,7847
24,68,18856,18924,-1,94,18924,16039
24,88,18924,19012,1,19,18924,7848
24,88,18924,19012,-1,19,19012,16040
24,236,19012,19248,1,110,19012,7849
24,236,19012,19248,-1,110,19248,16041
24,139,19248,19387,1,123,19248,7850
24,139,19248,19387,-1,123,19387,16042
24,69,19387,19456,1,131,19387,7851
24,69,19387,19456,-1,131,19456,16043
24,28,19456,19484,1,37,19456,7852
24,28,19456,19484,-1,37,19484,16044
24,131,19484,19615,1,163,19484,7853
24,131,19484,19615,-1,163,19615,16045
24,74,19615,19689,1,85,19615,7854
24,74,19615,19689,-1,85,19689,16046
24,112,19689,19801,1,124,19689,7855
24,112,19689,19801,-1,124,19801,16047
24,218,19801,20019,1,50,19801,7856
24,218,19801,20019,-1,50,20019,16048
24,130,20019,20149,1,242,20019,7857
24,130,20019,20149,-1,242,20149,16049
24,98,20149,20247,1,190,20149,7858
24,98,20149,20247,-1,190,20247,16050
24,57,20247,20304,1,143,20247,7859
24,57,20247,20304,-1,143,20304,16051
24,82,20304,20386,1,166,20304,7860
24,82,20304,20386,-1,166,20386,16052
24,154,20386,20540,1,112,20386,7861
24,154,20386,20540,-1,112,20540,16053
24,80,20540,20620,1,242,20540,7862
24,80,20540,20620,-1,242,20620,16054
24,48,20620,20668,1,19,20620,7863
24,48,20620,20668,-1,19,20668,16055
24,146,20668,20814,1,196,20668,7864
24,146,20668,20814,-1,196,20814,16056
24,196,20814,21010,1,193,20814,7865
24,196,20814,21010,-1,193,21010,16057
24,138,21010,21148,1,184,21010,7866
24,138,21010,21148,-1,184,21148,16058
24,174,21148,21322,1,71,21148,7867
24,174,21148,21322,-1,71,21322,16059
24,67,21322,21389,1,218,21322,7868
24,67,21322,21389,-1,218,21389,16060
24,308,21389,21697,1,49,21389,7869
24,308,21389,21697,-1,49,21697,16061
24,139,21697,21836,1,34,21697,7870
24,139,21697,21836,-1,34,21836,16062
24,73,21836,21909,1,194,21836,7871
24,73,21836,21909,-1,194,21909,16063
24,55,21909,21964,1,198,21909,7872
24,55,21909,21964,-1,198,21964,16064
24,134,21964,22098,1,75,21964,7873
24,134,21964,22098,-1,75,22098,16065
24,171,22098,22269,1,27,22098,7874
24,171,22098,22269,-1,27,22269,16066
24,56,22269,22325,1,215,22269,7875
24,56,22269,22325,-1,215,22325,16067
24,117,22325,22442,1,194,22325,7876
24,117,22325,22442,-1,194,22442,16068
24,69,22442,22511,1,68,22442,7877
24,69,22442,22511,-1,68,22511,16069
24,90,22511,22601,1,106,22511,7878
24,90,22511,22601,-1,106,22601,16070
24,47,22601,22648,1,20,22601,7879
24,47,22601,22648,-1,20,22648,16071
24,166,22648,22814,1,250,22648,7880
24,166,22648,22814,-1,250,22814,16072
24,183,22814,22997,1,125,22814,7881
24,183,22814,22997,-1,125,22997,16073
24,143,22997,23140,1,135,22997,7882
24,143,22997,23140,-1,135,23140,16074
24,40,23140,23180,1,226,23140,7883
24,40,23140,23180,-1,226,23180,16075
24,135,23180,23315,1,28,23180,7884
24,135,23180,23315,-1,28,23315,16076
24,141,23315,23456,1,29,23315,7885
24,141,23315,23456,-1,29,23456,16077
24,191,23456,23647,1,71,23456,7886
24,191,23456,23647,-1,71,23647,16078
24,111,23647,23758,1,212,23647,7887
24,111,23647,23758,-1,212,23758,16079
24,68,23758,23826,1,98,23758,7888
24,68,23758,23826,-1,98,23826,16080
24,73,23826,23899,1,179,23826,7889
24,73,23826,23899,-1,179,23899,16081
24,317,23899,24216,1,8,23899,7890
24,317,23899,24216,-1,8,24216,16082
24,304,24216,24520,1,135,24216,7891
24,304,24216,24520,-1,135,24520,16083
24,39,24520,24559,1,234,24520,7892
24,39,24520,24559,-1,234,24559,16084
24,122,24559,24681,1,250,24559,7893
24,122,24559,24681,-1,250,24681,16085
24,121,24681,24802,1,98,24681,7894
24,121,24681,24802,-1,98,24802,16086
24,27,24802,24829,1,41,24802,7895
24,27,24802,24829,-1,41,24829,16087
24,314,24829,25143,1,222,24829,7896
24,314,24829,25143,-1,222,25143,16088
24,71,25143,25214,1,159,25143,7897
24,71,25143,25214,-1,159,25214,16089
24,64,25214,25278,1,244,25214,7898
24,64,25214,25278,-1,244,25278,16090
24,89,25278,25367,1,254,25278,7899
24,89,25278,25367,-1,254,25367,16091
24,187,25367,25554,1,28,25367,7900
24,187,25367,25554,-1,28,25554,16092
24,118,25554,25672,1,254,25554,7901
24,118,25554,25672,-1,254,25672,16093
24,134,25672,25806,1,138,25672,7902
24,134,25672,25806,-1,138,25806,16094
24,110,25806,25916,1,47,25806,7903
24,110,25806,25916,-1,47,25916,16095
24,199,25916,26115,1,155,25916,7904
24,199,25916,26115,-1,155,26115,16096
24,134,26115,26249,1,234,26115,7905
24,134,26115,26249,-1,234,26249,16097
24,83,26249,26332,1,223,26249,7906
24,83,26249,26332,-1,223,26332,16098
24,154,26332,26486,1,80,26332,7907
24,154,26332,26486,-1,80,26486,16099
24,96,26486,26582,1,80,26486,7908
24,96,26486,26582,-1,80,26582,16100
24,159,26582,26741,1,227,26582,7909
24,159,26582,26741,-1,227,26741,16101
24,159,26741,26900,1,53,26741,7910
24,159,26741,26900,-1,53,26900,16102
24,123,26900,27023,1,202,26900,7911
24,123,26900,27023,-1,202,27023,16103
24,46,27023,27069,1,73,27023,7912
24,46,27023,27069,-1,73,27069,16104
24,98,27069,27167,1,146,27069,7913
24,98,27069,27167,-1,146,27167,16105
24,92,27167,27259,1,208,27167,7914
24,92,27167,27259,-1,208,27259,16106
24,121,27259,27380,1,223,27259,7915
24,121,27259,27380,-1,223,27380,16107
24,67,27380,27447,1,88,27380,7916
24,67,27380,27447,-1,88,27447,16108
24,233,27447,27680,1,93,27447,7917
24,233,27447,27680,-1,93,27680,16109
24,114,27680,27794,1,224,27680,7918
24,114,27680,27794,-1,224,27794,16110
24,188,27794,27982,1,123,27794,7919
24,188,27794,27982,-1,123,27982,16111
24,85,27982,28067,1,16,27982,7920
24,85,27982,28067,-1,16,28067,16112
24,139,28067,28206,1,45,28067,7921
24,139,28067,28206,-1,45,28206,16113
24,89,28206,28295,1,256,28206,7922
24,89,28206,28295,-1,256,28295,16114
24,99,28295,28394,1,194,28295,7923
24,99,28295,28394,-1,194,28394,16115
24,86,28394,28480,1,170,28394,7924
24,86,28394,28480,-1,170,28480,16116
24,66,28480,28546,1,95,28480,7925
24,66,28480,28546,-1,95,28546,16117
24,177,28546,28723,1,181,28546,7926
24,177,28546,28723,-1,181,28723,16118
24,99,28723,28822,1,206,28723,7927
24,99,28723,28822,-1,206,28822,16119
24,120,28822,28942,1,206,28822,7928
24,120,28822,28942,-1,206,28942,16120
24,177,28942,29119,1,194,28942,7929
24,177,28942,29119,-1,194,29119,16121
24,152,29119,29271,1,166,29119,7930
24,152,29119,29271,-1,166,29271,16122
24,39,29271,29310,1,74,29271,7931
24,39,29271,29310,-1,74,29310,16123
24,135,29310,29445,1,52,29310,7932
24,135,29310,29445,-1,52,29445,16124
24,260,29445,29705,1,33,29445,7933
24,260,29445,29705,-1,33,29705,16125
24,118,29705,29823,1,82,29705,7934
24,118,29705,29823,-1,82,29823,16126
24,94,29823,29917,1,172,29823,7935
24,94,29823,29917,-1,172,29917,16127
24,180,29917,30097,1,77,29917,7936
24,180,29917,30097,-1,77,30097,16128
24,44,30097,30141,1,256,30097,7937
24,44,30097,30141,-1,256,30141,16129
24,124,30141,30265,1,251,30141,7938
24,124,30141,30265,-1,251,30265,16130
24,102,30265,30367,1,224,30265,7939
24,102,30265,30367,-1,224,30367,16131
24,183,30367,30550,1,15,30367,7940
24,183,30367,30550,-1,15,30550,16132
24,76,30550,30626,1,177,30550,7941
24,76,30550,30626,-1,177,30626,16133
24,125,30626,30751,1,219,30626,7942
24,125,30626,30751,-1,219,30751,16134
24,67,30751,30818,1,125,30751,7943
24,67,30751,30818,-1,125,30818,16135
24,191,30818,31009,1,221,30818,7944
24,191,30818,31009,-1,221,31009,16136
24,44,31009,31053,1,218,31009,7945
24,44,31009,31053,-1,218,31053,16137
24,150,31053,31203,1,39,31053,7946
24,150,31053,31203,-1,39,31203,16138
24,96,31203,31299,1,43,31203,7947
24,96,31203,31299,-1,43,31299,16139
24,134,31299,31433,1,199,31299,7948
24,134,31299,31433,-1,199,31433,16140
24,37,31433,31470,1,83,31433,7949
24,37,31433,31470,-1,83,31470,16141
24,108,31470,31578,1,34,31470,7950
24,108,31470,31578,-1,34,31578,16142
24,169,31578,31747,1,227,31578,7951
24,169,31578,31747,-1,227,31747,16143
24,172,31747,31919,1,72,31747,7952
24,172,31747,31919,-1,72,31919,16144
24,65,31919,31984,1,65,31919,7953
24,65,31919,31984,-1,65,31984,16145
24,141,31984,32125,1,19,31984,7954
24,141,31984,32125,-1,19,32125,16146
24,41,32125,32166,1,232,32125,7955
24,41,32125,32166,-1,232,32166,16147
24,149,32166,32315,1,120,32166,7956
24,149,32166,32315,-1,120,32315,16148
24,141,32315,32456,1,123,32315,7957
24,141,32315,32456,-1,123,32456,16149
24,94,32456,32550,1,171,32456,7958
24,94,32456,32550,-1,171,32550,16150
24,166,32550,32716,1,56,32550,7959
24,166,32550,32716,-1,56,32716,16151
24,164,32716,32880,1,152,32716,7960
24,164,32716,32880,-1,152,32880,16152
24,212,32880,33092,1,33,32880,7961
24,212,32880,33092,-1,33,33092,16153
24,195,33092,33287,1,109,33092,7962
24,195,33092,33287,-1,109,33287,16154
24,24,33287,33311,1,180,33287,7963
24,24,33287,33311,-1,180,33311,16155
24,238,33311,33549,1,53,33311,7964
24,238,33311,33549,-1,53,33549,16156
25,91,0,91,1,87,0,1811
25,91,0,91,-1,87,91,10003
25,166,91,257,1,196,91,1812
25,166,91,257,-1,196,257,10004
25,202,257,459,1,155,257,1813
25,202,257,459,-1,155,459,10005
25,192,459,651,1,135,459,1814
25,192,459,651,-1,135,651,10006
25,167,651,818,1,98,651,1815
25,167,651,818,-1,98,818,10007
25,85,818,903,1,15,818,1816
25,85,818,903,-1,15,903,10008
25,144,903,1047,1,74,903,1817
25,144,903,1047,-1,74,1047,10009
25,258,1047,1305,1,148,1047,1818
25,258,1047,1305,-1,148,1305,10010
25,134,1305,1439,1,112,1305,1819
25,134,1305,1439,-1,112,1439,10011
25,173,1439,1612,1,256,1439,1820
25,173,1439,1612,-1,256,1612,10012
25,143,1612,1755,1,160,1612,1821
25,143,1612,1755,-1,160,1755,10013
25,204,1755,1959,1,21,1755,1822
25,204,1755,1959,-1,21,1959,10014
25,269,1959,2228,1,227,1959,1823
25,269,1959,2228,-1,227,2228,10015
25,115,2228,2343,1,30,2228,1824
25,115,2228,2343,-1,30,2343,10016
25,64,2343,2407,1,252,2343,1825
25,64,2343,2407,-1,252,2407,10017
25,168,2407,2575,1,193,2407,1826
25,168,2407,2575,-1,193,2575,10018
25,102,2575,2677,1,183,2575,1827
25,102,2575,2677,-1,183,2677,10019
25,220,2677,2897,1,98,2677,1828
25,220,2677,2897,-1,98,2897,10020
25,63,2897,2960,1,174,2897,1829
25,63,2897,2960,-1,174,2960,10021
25,52,2960,3012,1,77,2960,1830
25,52,2960,3012,-1,77,3012,10022
25,81,3012,3093,1,238,3012,1831
25,81,3012,3093,-1,238,3093,10023
25,149,3093,3242,1,96,3093,1832
25,149,3093,3242,-1,96,3242,10024
25,78,3242,3320,1,32,3242,1833
25,78,3242,3320,-1,32,3320,10025
25,137,3320,3457,1,187,3320,1834
25,137,3320,3457,-1,187,3457,10026
25,174,3457,3631,1,141,3457,1835
25,174,3457,3631,-1,141,3631,10027
25,113,3631,3744,1,74,3631,1836
25,113,3631,3744,-1,74,3744,10028
25,115,3744,3859,1,136,3744,1837
25,115,3744,3859,-1,136,3859,10029
25,98,3859,3957,1,224,3859,1838
25,98,3859,3957,-1,224,3957,10030
25,143,3957,4100,1,34,3957,1839
25,143,3957,4100,-1,34,4100,10031
25,183,4100,4283,1,214,4100,1840
25,183,4100,4283,-1,214,4283,10032
25,52,4283,4335,1,211,4283,1841
25,52,4283,4335,-1,211,4335,10033
25,81,4335,4416,1,222,4335,1842
25,81,4335,4416,-1,222,4416,10034
25,113,4416,4529,1,85,4416,1843
25,113,4416,4529,-1,85,4529,10035
25,170,4529,4699,1,246,4529,1844
25,170,4529,4699,-1,246,4699,10036
25,80,4699,4779,1,66,4699,1845
25,80,4699,4779,-1,66,4779,10037
25,96,4779,4875,1,136,4779,1846
25,96,4779,4875,-1,136,4875,10038
25,159,4875,5034,1,181,4875,1847
25,159,4875,5034,-1,181,5034,10039
25,123,5034,5157,1,142,5034,1848
25,123,5034,5157,-1,142,5157,10040
25,85,5157,5242,1,108,5157,1849
25,85,5157,5242,-1,108,5242,10041
25,203,5242,5445,1,146,5242,1850
25,203,5242,5445,-1,146,5445,10042
25,244,5445,5689,1,113,5445,1851
25,244,5445,5689,-1,113,5689,10043
25,238,5689,5927,1,39,5689,1852
25,238,5689,5927,-1,39,5927,10044
25,224,5927,6151,1,83,5927,1853
25,224,5927,6151,-1,83,6151,10045
25,254,6151,6405,1,229,6151,1854
25,254,6151,6405,-1,229,6405,10046
25,414,6405,6819,1,4,6405,1855
25,414,6405,6819,-1,4,6819,10047
25,84,6819,6903,1,204,6819,1856
25,84,6819,6903,-1,204,6903,10048
25,149,6903,7052,1,182,6903,1857
25,149,6903,7052,-1,182,7052,10049
25,124,7052,7176,1,33,7052,1858
25,124,7052,7176,-1,33,7176,10050
25,108,7176,7284,1,32,7176,1859
25,108,7176,7284,-1,32,7284,10051
25,42,7284,7326,1,65,7284,1860
25,42,7284,7326,-1,65,7326,10052
25,190,7326,7516,1,225,7326,1861
25,190,7326,7516,-1,225,7516,10053
25,111,7516,7627,1,256,7516,1862
25,111,7516,7627,-1,256,7627,10054
25,103,7627,7730,1,243,7627,1863
25,103,7627,7730,-1,243,7730,10055
25,129,7730,7859,1,113,7730,1864
25,129,7730,7859,-1,113,7859,10056
25,57,7859,7916,1,214,7859,1865
25,57,7859,7916,-1,214,7916,10057
25,107,7916,8023,1,196,7916,1866
25,107,7916,8023,-1,196,8023,10058
25,284,8023,8307,1,10,8023,1867
25,284,8023,8307,-1,10,8307,10059
25,72,8307,8379,1,186,8307,1868
25,72,8307,8379,-1,186,8379,10060
25,139,8379,8518,1,220,8379,1869
25,139,8379,8518,-1,220,8518,10061
25,125,8518,8643,1,18,8518,1870
25,125,8518,8643,-1,18,8643,10062
25,124,8643,8767,1,67,8643,1871
25,124,8643,8767,-1,67,8767,10063
25,189,8767,8956,1,2,8767,1872
25,189,8767,8956,-1,2,8956,10064
25,173,8956,9129,1,219,8956,1873
25,173,8956,9129,-1,219,9129,10065
25,42,9129,9171,1,76,9129,1874
25,42,9129,9171,-1,76,9171,10066
25,171,9171,9342,1,101,9171,1875
25,171,9171,9342,-1,101,9342,10067
25,142,9342,9484,1,253,9342,1876
25,142,9342,9484,-1,253,9484,10068
25,84,9484,9568,1,186,9484,1877
25,84,9484,9568,-1,186,9568,10069
25,111,9568,9679,1,256,9568,1878
25,111,9568,9679,-1,256,9679,10070
25,83,9679,9762,1,116,9679,1879
25,83,9679,9762,-1,116,9762,10071
25,58,9762,9820,1,190,9762,1880
25,58,9762,9820,-1,190,9820,10072
25,202,9820,10022,1,141,9820,1881
25,202,9820,10022,-1,141,10022,10073
25,118,10022,10140,1,256,10022,1882
25,118,10022,10140,-1,256,10140,10074
25,57,10140,10197,1,188,10140,1883
25,57,10140,10197,-1,188,10197,10075
25,106,10197,10303,1,218,10197,1884
25,106,10197,10303,-1,218,10303,10076
25,29,10303,10332,1,134,10303,1885
25,29,10303,10332,-1,134,10332,10077
25,172,10332,10504,1,95,10332,1886
25,172,10332,10504,-1,95,10504,10078
25,77,10504,10581,1,55,10504,1887
25,77,10504,10581,-1,55,10581,10079
25,142,10581,10723,1,54,10581,1888
25,142,10581,10723,-1,54,10723,10080
25,53,10723,10776,1,54,10723,1889
25,53,10723,10776,-1,54,10776,10081
25,155,10776,10931,1,108,10776,1890
25,155,10776,10931,-1,108,10931,10082
25,175,10931,11106,1,192,10931,1891
25,175,10931,11106,-1,192,11106,10083
25,117,11106,11223,1,225,11106,1892
25,117,11106,11223,-1,225,11223,10084
25,23,11223,11246,1,243,11223,1893
25,23,11223,11246,-1,243,11246,10085
25,115,11246,11361,1,5,11246,1894
25,115,11246,11361,-1,5,11361,10086
25,72,11361,11433,1,59,11361,1895
25,72,11361,11433,-1,59,11433,10087
25,129,11433,11562,1,23,11433,1896
25,129,11433,11562,-1,23,11562,10088
25,30,11562,11592,1,196,11562,1897
25,30,11562,11592,-1,196,11592,10089
25,127,11592,11719,1,84,11592,1898
25,127,11592,11719,-1,84,11719,10090
25,148,11719,11867,1,105,11719,1899
25,148,11719,11867,-1,105,11867,10091
25,158,11867,12025,1,161,11867,1900
25,158,11867,12025,-1,161,12025,10092
25,124,12025,12149,1,24,12025,1901
25,124,12025,12149,-1,24,12149,10093
25,181,12149,12330,1,100,12149,1902
25,181,12149,12330,-1,100,12330,10094
25,257,12330,12587,1,194,12330,1903
25,257,12330,12587,-1,194,12587,10095
25,129,12587,12716,1,250,12587,1904
25,129,12587,12716,-1,250,12716,10096
25,354,12716,13070,1,65,12716,1905
25,354,12716,13070,-1,65,13070,10097
25,176,13070,13246,1,181,13070,1906
25,176,13070,13246,-1,181,13246,10098
25,127,13246,13373,1,83,13246,1907
25,127,13246,13373,-1,83,13373,10099
25,73,13373,13446,1,67,13373,1908
25,73,13373,13446,-1,67,13446,10100
25,210,13446,13656,1,2,13446,1909
25,210,13446,13656,-1,2,13656,10101
25,104,13656,13760,1,49,13656,1910
25,104,13656,13760,-1,49,13760,10102
25,44,13760,13804,1,102,13760,1911
25,44,13760,13804,-1,102,13804,10103
25,89,13804,13893,1,93,13804,1912
25,89,13804,13893,-1,93,13893,10104
25,126,13893,14019,1,35,13893,1913
25,126,13893,14019,-1,35,14019,10105
25,189,14019,14208,1,189,14019,1914
25,189,14019,14208,-1,189,14208,10106
25,168,14208,14376,1,43,14208,1915
25,168,14208,14376,-1,43,14376,10107
25,69,14376,14445,1,254,14376,1916
25,69,14376,14445,-1,254,14445,10108
25,166,14445,14611,1,38,14445,1917
25,166,14445,14611,-1,38,14611,10109
25,184,14611,14795,1,15,14611,1918
25,184,14611,14795,-1,15,14795,10110
25,148,14795,14943,1,126,14795,1919
25,148,14795,14943,-1,126,14943,10111
25,199,14943,15142,1,98,14943,1920
25,199,14943,15142,-1,98,15142,10112
25,29,15142,15171,1,244,15142,1921
25,29,15142,15171,-1,244,15171,10113
25,29,15171,15200,1,12,15171,1922
25,29,15171,15200,-1,12,15200,10114
25,62,15200,15262,1,11,15200,1923
25,62,15200,15262,-1,11,15262,10115
25,113,15262,15375,1,187,15262,1924
25,113,15262,15375,-1,187,15375,10116
25,63,15375,15438,1,17,15375,1925
25,63,15375,15438,-1,17,15438,10117
25,100,15438,15538,1,219,15438,1926
25,100,15438,15538,-1,219,15538,10118
25,200,15538,15738,1,34,15538,1927
25,200,15538,15738,-1,34,15738,10119
25,103,15738,15841,1,190,15738,1928
25,103,15738,15841,-1,190,15841,10120
25,222,15841,16063,1,30,15841,1929
25,222,15841,16063,-1,30,16063,10121
25,139,16063,16202,1,29,16063,1930
25,139,16063,16202,-1,29,16202,10122
25,159,16202,16361,1,53,16202,1931
25,159,16202,16361,-1,53,16361,10123
25,168,16361,16529,1,148,16361,1932
25,168,16361,16529,-1,148,16529,10124
25,118,16529,16647,1,31,16529,1933
25,118,16529,16647,-1,31,16647,10125
25,82,16647,16729,1,178,16647,1934
25,82,16647,16729,-1,178,16729,10126
25,153,16729,16882,1,137,16729,1935
25,153,16729,16882,-1,137,16882,10127
25,192,16882,17074,1,107,16882,1936
25,192,16882,17074,-1,107,17074,10128
25,149,17074,17223,1,82,17074,1937
25,149,17074,17223,-1,82,17223,10129
25,72,17223,17295,1,135,17223,1938
25,72,17223,17295,-1,135,17295,10130
25,65,17295,17360,1,55,17295,1939
25,65,17295,17360,-1,55,17360,10131
25,89,17360,17449,1,222,17360,1940
25,89,17360,17449,-1,222,17449,10132
25,141,17449,17590,1,77,17449,1941
25,141,17449,17590,-1,77,17590,10133
25,145,17590,17735,1,40,17590,1942
25,145,17590,17735,-1,40,17735,10134
25,59,17735,17794,1,170,17735,1943
25,59,17735,17794,-1,170,17794,10135
25,73,17794,17867,1,69,17794,1944
25,73,17794,17867,-1,69,17867,10136
25,51,17867,17918,1,162,17867,1945
25,51,17867,17918,-1,162,17918,10137
25,115,17918,18033,1,222,17918,1946
25,115,17918,18033,-1,222,18033,10138
25,393,18033,18426,1,77,18033,1947
25,393,18033,18426,-1,77,18426,10139
25,52,18426,18478,1,43,18426,1948
25,52,18426,18478,-1,43,18478,10140
25,106,18478,18584,1,217,18478,1949
25,106,18478,18584,-1,217,18584,10141
25,42,18584,18626,1,239,18584,1950
25,42,18584,18626,-1,239,18626,10142
25,36,18626,18662,1,218,18626,1951
25,36,18626,18662,-1,218,18662,10143
25,98,18662,18760,1,6,18662,1952
25,98,18662,18760,-1,6,18760,10144
25,76,18760,18836,1,32,18760,1953
25,76,18760,18836,-1,32,18836,10145
25,174,18836,19010,1,242,18836,1954
25,174,18836,19010,-1,242,19010,10146
25,82,19010,19092,1,146,19010,1955
25,82,19010,19092,-1,146,19092,10147
25,143,19092,19235,1,246,19092,1956
25,143,19092,19235,-1,246,19235,10148
25,55,19235,19290,1,238,19235,1957
25,55,19235,19290,-1,238,19290,10149
25,142,19290,19432,1,69,19290,1958
25,142,19290,19432,-1,69,19432,10150
25,85,19432,19517,1,19,19432,1959
25,85,19432,19517,-1,19,19517,10151
25,60,19517,19577,1,240,19517,1960
25,60,19517,19577,-1,240,19577,10152
25,212,19577,19789,1,189,19577,1961
25,212,19577,19789,-1,189,19789,10153
25,148,19789,19937,1,99,19789,1962
25,148,19789,19937,-1,99,19937,10154
25,49,19937,19986,1,209,19937,1963
25,49,19937,19986,-1,209,19986,10155
25,162,19986,20148,1,201,19986,1964
25,162,19986,20148,-1,201,20148,10156
25,82,20148,20230,1,35,20148,1965
25,82,20148,20230,-1,35,20230,10157
25,83,20230,20313,1,184,20230,1966
25,83,20230,20313,-1,184,20313,10158
25,207,20313,20520,1,49,20313,1967
25,207,20313,20520,-1,49,20520,10159
25,126,20520,20646,1,252,20520,1968
25,126,20520,20646,-1,252,20646,10160
25,267,20646,20913,1,161,20646,1969
25,267,20646,20913,-1,161,20913,10161
25,106,20913,21019,1,176,20913,1970
25,106,20913,21019,-1,176,21019,10162
25,101,21019,21120,1,29,21019,1971
25,101,21019,21120,-1,29,21120,10163
25,127,21120,21247,1,17,21120,1972
25,127,21120,21247,-1,17,21247,10164
25,64,21247,21311,1,88,21247,1973
25,64,21247,21311,-1,88,21311,10165
25,81,21311,21392,1,99,21311,1974
25,81,21311,21392,-1,99,21392,10166
25,91,21392,21483,1,41,21392,1975
25,91,21392,21483,-1,41,21483,10167
25,148,21483,21631,1,137,21483,1976
25,148,21483,21631,-1,137,21631,10168
25,84,21631,21715,1,136,21631,1977
25,84,21631,21715,-1,136,21715,10169
25,101,21715,21816,1,80,21715,1978
25,101,21715,21816,-1,80,21816,10170
25,97,21816,21913,1,157,21816,1979
25,97,21816,21913,-1,157,21913,10171
25,71,21913,21984,1,222,21913,1980
25,71,21913,21984,-1,222,21984,10172
25,137,21984,22121,1,66,21984,1981
25,137,21984,22121,-1,66,22121,10173
25,247,22121,22368,1,173,22121,1982
25,247,22121,22368,-1,173,22368,10174
25,211,22368,22579,1,115,22368,1983
25,211,22368,22579,-1,115,22579,10175
25,115,22579,22694,1,102,22579,1984
25,115,22579,22694,-1,102,22694,10176
25,31,22694,22725,1,35,22694,1985
25,31,22694,22725,-1,35,22725,10177
25,158,22725,22883,1,120,22725,1986
25,158,22725,22883,-1,120,22883,10178
25,190,22883,23073,1,144,22883,1987
25,190,22883,23073,-1,144,23073,10179
25,291,23073,23364,1,74,23073,1988
25,291,23073,23364,-1,74,23364,10180
25,134,23364,23498,1,126,23364,1989
25,134,23364,23498,-1,126,23498,10181
25,208,23498,23706,1,98,23498,1990
25,208,23498,23706,-1,98,23706,10182
25,184,23706,23890,1,182,23706,1991
25,184,23706,23890,-1,182,23890,10183
25,178,23890,24068,1,105,23890,1992
25,178,23890,24068,-1,105,24068,10184
25,166,24068,24234,1,90,24068,1993
25,166,24068,24234,-1,90,24234,10185
25,270,24234,24504,1,192,24234,1994
25,270,24234,24504,-1,192,24504,10186
25,56,24504,24560,1,221,24504,1995
25,56,24504,24560,-1,221,24560,10187
25,105,24560,24665,1,101,24560,1996
25,105,24560,24665,-1,101,24665,10188
25,237,24665,24902,1,51,24665,1997
25,237,24665,24902,-1,51,24902,10189
25,216,24902,25118,1,162,24902,1998
25,216,24902,25118,-1,162,25118,10190
25,106,25118,25224,1,129,25118,1999
25,106,25118,25224,-1,129,25224,10191
25,43,25224,25267,1,181,25224,2000
25,43,25224,25267,-1,181,25267,10192
25,53,25267,25320,1,187,25267,2001
25,53,25267,25320,-1,187,25320,10193
25,175,25320,25495,1,147,25320,2002
25,175,25320,25495,-1,147,25495,10194
25,112,25495,25607,1,99,25495,2003
25,112,25495,25607,-1,99,25607,10195
25,102,25607,25709,1,40,25607,2004
25,102,25607,25709,-1,40,25709,10196
25,112,25709,25821,1,82,25709,2005
25,112,25709,25821,-1,82,25821,10197
25,240,25821,26061,1,202,25821,2006
25,240,25821,26061,-1,202,26061,10198
25,87,26061,26148,1,64,26061,2007
25,87,26061,26148,-1,64,26148,10199
25,58,26148,26206,1,99,26148,2008
25,58,26148,26206,-1,99,26206,10200
25,104,26206,26310,1,175,26206,2009
25,104,26206,26310,-1,175,26310,10201
25,241,26310,26551,1,179,26310,2010
25,241,26310,26551,-1,179,26551,10202
25,91,26551,26642,1,226,26551,2011
25,91,26551,26642,-1,226,26642,10203
25,143,26642,26785,1,214,26642,2012
25,143,26642,26785,-1,214,26785,10204
25,71,26785,26856,1,122,26785,2013
25,71,26785,26856,-1,122,26856,10205
25,57,26856,26913,1,69,26856,2014
25,57,26856,26913,-1,69,26913,10206
25,168,26913,27081,1,8,26913,2015
25,168,26913,27081,-1,8,27081,10207
25,56,27081,27137,1,137,27081,2016
25,56,27081,27137,-1,137,27137,10208
25,61,27137,27198,1,98,27137,2017
25,61,27137,27198,-1,98,27198,10209
25,71,27198,27269,1,139,27198,2018
25,71,27198,27269,-1,139,27269,10210
25,80,27269,27349,1,89,27269,2019
25,80,27269,27349,-1,89,27349,10211
25,136,27349,27485,1,15,27349,2020
25,136,27349,27485,-1,15,27485,10212
25,55,27485,27540,1,178,27485,2021
25,55,27485,27540,-1,178,27540,10213
25,207,27540,27747,1,202,27540,2022
25,207,27540,27747,-1,202,27747,10214
25,243,27747,27990,1,140,27747,2023
25,243,27747,27990,-1,140,27990,10215
25,293,27990,28283,1,206,27990,2024
25,293,27990,28283,-1,206,28283,10216
25,63,28283,28346,1,135,28283,2025
25,63,28283,28346,-1,135,28346,10217
25,169,28346,28515,1,146,28346,2026
25,169,28346,28515,-1,146,28515,10218
25,120,28515,28635,1,95,28515,2027
25,120,28515,28635,-1,95,28635,10219
25,77,28635,28712,1,60,28635,2028
25,77,28635,28712,-1,60,28712,10220
25,183,28712,28895,1,168,28712,2029
25,183,28712,28895,-1,168,28895,10221
25,121,28895,29016,1,36,28895,2030
25,121,28895,29016,-1,36,29016,10222
25,109,29016,29125,1,18,29016,2031
25,109,29016,29125,-1,18,29125,10223
25,112,29125,29237,1,45,29125,2032
25,112,29125,29237,-1,45,29237,10224
25,110,29237,29347,1,184,29237,2033
25,110,29237,29347,-1,184,29347,10225
25,91,29347,29438,1,210,29347,2034
25,91,29347,29438,-1,210,29438,10226
25,112,29438,29550,1,222,29438,2035
25,112,29438,29550,-1,222,29550,10227
25,45,29550,29595,1,63,29550,2036
25,45,29550,29595,-1,63,29595,10228
25,95,29595,29690,1,154,29595,2037
25,95,29595,29690,-1,154,29690,10229
25,262,29690,29952,1,20,29690,2038
25,262,29690,29952,-1,20,29952,10230
25,159,29952,30111,1,36,29952,2039
25,159,29952,30111,-1,36,30111,10231
25,106,30111,30217,1,148,30111,2040
25,106,30111,30217,-1,148,30217,10232
25,113,30217,30330,1,167,30217,2041
25,113,30217,30330,-1,167,30330,10233
25,130,30330,30460,1,242,30330,2042
25,130,30330,30460,-1,242,30460,10234
25,371,30460,30831,1,221,30460,2043
25,371,30460,30831,-1,221,30831,10235
25,223,30831,31054,1,146,30831,2044
25,223,30831,31054,-1,146,31054,10236
25,77,31054,31131,1,175,31054,2045
25,77,31054,31131,-1,175,31131,10237
26,65,0,65,1,100,0,5429
26,65,0,65,-1,100,65,13621
26,216,65,281,1,58,65,5430
26,216,65,281,-1,58,281,13622
26,32,281,313,1,220,281,5431
26,32,281,313,-1,220,313,13623
26,55,313,368,1,156,313,5432
26,55,313,368,-1,156,368,13624
26,88,368,456,1,38,368,5433
26,88,368,456,-1,38,456,13625
26,42,456,498,1,151,456,5434
26,42,456,498,-1,151,498,13626
26,62,498,560,1,146,498,5435
26,62,498,560,-1,146,560,13627
26,108,560,668,1,102,560,5436
26,108,560,668,-1,102,668,13628
26,108,668,776,1,133,668,5437
26,108,668,776,-1,133,776,13629
26,88,776,864,1,234,776,5438
26,88,776,864,-1,234,864,13630
26,117,864,981,1,218,864,5439
26,117,864,981,-1,218,981,13631
26,100,981,1081,1,87,981,5440
26,100,981,1081,-1,87,1081,13632
26,43,1081,1124,1,199,1081,5441
26,43,1081,1124,-1,199,1124,13633
26,218,1124,1342,1,148,1124,5442
26,218,1124,1342,-1,148,1342,13634
26,114,1342,1456,1,214,1342,5443
26,114,1342,1456,-1,214,1456,13635
26,426,1456,1882,1,251,1456,5444
26,426,1456,1882,-1,251,1882,13636
26,336,1882,2218,1,216,1882,5445
26,336,1882,2218,-1,216,2218,13637
26,63,2218,2281,1,27,2218,5446
26,63,2218,2281,-1,27,2281,13638
26,122,2281,2403,1,250,2281,5447
26,122,2281,2403,-1,250,2403,13639
26,191,2403,2594,1,101,2403,5448
26,191,2403,2594,-1,101,2594,13640
26,65,2594,2659,1,159,2594,5449
26,65,2594,2659,-1,159,2659,13641
26,54,2659,2713,1,231,2659,5450
26,54,2659,2713,-1,231,2713,13642
26,91,2713,2804,1,62,2713,5451
26,91,2713,2804,-1,62,2804,13643
26,207,2804,3011,1,6,2804,5452
26,207,2804,3011,-1,6,3011,13644
26,108,3011,3119,1,218,3011,5453
26,108,3011,3119,-1,218,3119,13645
26,170,3119,3289,1,29,3119,5454
26,170,3119,3289,-1,29,3289,13646
26,109,3289,3398,1,101,3289,5455
26,109,3289,3398,-1,101,3398,13647
26,75,3398,3473,1,46,3398,5456
26,75,3398,3473,-1,46,3473,13648
26,92,3473,3565,1,8,3473,5457
26,92,3473,3565,-1,8,3565,13649
26,98,3565,3663,1,147,3565,5458
26,98,3565,3663,-1,147,3663,13650
26,154,3663,3817,1,10,3663,5459
26,154,3663,3817,-1,10,3817,13651
26,70,3817,3887,1,225,3817,5460
26,70,3817,3887,-1,225,3887,13652
26,140,3887,4027,1,227,3887,5461
26,140,3887,4027,-1,227,4027,13653
26,64,4027,4091,1,89,4027,5462
26,64,4027,4091,-1,89,4091,13654
26,32,4091,4123,1,91,4091,5463
26,32,4091,4123,-1,91,4123,13655
26,256,4123,4379,1,23,4123,5464
26,256,4123,4379,-1,23,4379,13656
26,94,4379,4473,1,13,4379,5465
26,94,4379,4473,-1,13,4473,13657
26,52,4473,4525,1,198,4473,5466
26,52,4473,4525,-1,198,4525,13658
26,186,4525,4711,1,135,4525,5467
26,186,4525,4711,-1,135,4711,13659
26,167,4711,4878,1,164,4711,5468
26,167,4711,4878,-1,164,4878,13660
26,181,4878,5059,1,151,4878,5469
26,181,4878,5059,-1,151,5059,13661
26,146,5059,5205,1,32,5059,5470
26,146,5059,5205,-1,32,5205,13662
26,144,5205,5349,1,33,5205,5471
26,144,5205,5349,-1,33,5349,13663
26,16,5349,5365,1,77,5349,5472
26,16,5349,5365,-1,77,5365,13664
26,146,5365,5511,1,3,5365,5473
26,146,5365,5511,-1,3,5511,13665
26,157,5511,5668,1,41,5511,5474
26,157,5511,5668,-1,41,5668,13666
26,111,5668,5779,1,108,5668,5475
26,111,5668,5779,-1,108,5779,13667
26,160,5779,5939,1,106,5779,5476
26,160,5779,5939,-1,106,5939,13668
26,81,5939,6020,1,138,5939,5477
26,81,5939,6020,-1,138,6020,13669
26,98,6020,6118,1,70,6020,5478
26,98,6020,6118,-1,70,6118,13670
26,133,6118,6251,1,72,6118,5479
26,133,6118,6251,-1,72,6251,13671
26,86,6251,6337,1,233,6251,5480
26,86,6251,6337,-1,233,6337,13672
26,92,6337,6429,1,175,6337,5481
26,92,6337,6429,-1,175,6429,13673
26,138,6429,6567,1,206,6429,5482
26,138,6429,6567,-1,206,6567,13674
26,175,6567,6742,1,81,6567,5483
26,175,6567,6742,-1,81,6742,13675
26,214,6742,6956,1,234,6742,5484
26,214,6742,6956,-1,234,6956,13676
26,110,6956,7066,1,74,6956,5485
26,110,6956,7066,-1,74,7066,13677
26,156,7066,7222,1,196,7066,5486
26,156,7066,7222,-1,196,7222,13678
26,133,7222,7355,1,207,7222,5487
26,133,7222,7355,-1,207,7355,13679
26,145,7355,7500,1,110,7355,5488
26,145,7355,7500,-1,110,7500,13680
26,46,7500,7546,1,78,7500,5489
26,46,7500,7546,-1,78,7546,13681
26,84,7546,7630,1,25,7546,5490
26,84,7546,7630,-1,25,7630,13682
26,37,7630,7667,1,119,7630,5491
26,37,7630,7667,-1,119,7667,13683
26,312,7667,7979,1,69,7667,5492
26,312,7667,7979,-1,69,7979,13684
26,88,7979,8067,1,206,7979,5493
26,88,7979,8067,-1,206,8067,13685
26,175,8067,8242,1,57,8067,5494
26,175,8067,8242,-1,57,8242,13686
26,70,8242,8312,1,30,8242,5495
26,70,8242,8312,-1,30,8312,13687
26,133,8312,8445,1,144,8312,5496
26,133,8312,8445,-1,144,8445,13688
26,138,8445,8583,1,90,8445,5497
26,138,8445,8583,-1,90,8583,13689
26,113,8583,8696,1,253,8583,5498
26,113,8583,8696,-1,253,8696,13690
26,161,8696,8857,1,46,8696,5499
26,161,8696,8857,-1,46,8857,13691
26,176,8857,9033,1,75,8857,5500
26,176,8857,9033,-1,75,9033,13692
26,105,9033,9138,1,226,9033,5501
26,105,9033,9138,-1,226,9138,13693
26,126,9138,9264,1,185,9138,5502
26,126,9138,9264,-1,185,9264,13694
26,76,9264,9340,1,138,9264,5503
26,76,9264,9340,-1,138,9340,13695
26,181,9340,9521,1,157,9340,5504
26,181,9340,9521,-1,157,9521,13696
26,180,9521,9701,1,240,9521,5505
26,180,9521,9701,-1,240,9701,13697
26,111,9701,9812,1,203,9701,5506
26,111,9701,9812,-1,203,9812,13698
26,124,9812,9936,1,20,9812,5507
26,124,9812,9936,-1,20,9936,13699
26,144,9936,10080,1,160,9936,5508
26,144,9936,10080,-1,160,10080,13700
26,288,10080,10368,1,110,10080,5509
26,288,10080,10368,-1,110,10368,13701
26,70,10368,10438,1,250,10368,5510
26,70,10368,10438,-1,250,10438,13702
26,60,10438,10498,1,192,10438,5511
26,60,10438,10498,-1,192,10498,13703
26,129,10498,10627,1,113,10498,5512
26,129,10498,10627,-1,113,10627,13704
26,75,10627,10702,1,221,10627,5513
26,75,10627,10702,-1,221,10702,13705
26,99,10702,10801,1,116,10702,5514
26,99,10702,10801,-1,116,10801,13706
26,77,10801,10878,1,113,10801,5515
26,77,10801,10878,-1,113,10878,13707
26,143,10878,11021,1,24,10878,5516
26,143,10878,11021,-1,24,11021,13708
26,61,11021,11082,1,57,11021,5517
26,61,11021,11082,-1,57,11082,13709
26,143,11082,11225,1,220,11082,5518
26,143,11082,11225,-1,220,11225,13710
26,91,11225,11316,1,234,11225,5519
26,91,11225,11316,-1,234,11316,13711
26,76,11316,11392,1,252,11316,5520
26,76,11316,11392,-1,252,11392,13712
26,28,11392,11420,1,212,11392,5521
26,28,11392,11420,-1,212,11420,13713
26,49,11420,11469,1,65,11420,5522
26,49,11420,11469,-1,65,11469,13714
26,277,11469,11746,1,221,11469,5523
26,277,11469,11746,-1,221,11746,13715
26,133,11746,11879,1,23,11746,5524
26,133,11746,11879,-1,23,11879,13716
26,118,11879,11997,1,27,11879,5525
26,118,11879,11997,-1,27,11997,13717
26,124,11997,12121,1,75,11997,5526
26,124,11997,12121,-1,75,12121,13718
26,318,12121,12439,1,94,12121,5527
26,318,12121,12439,-1,94,12439,13719
26,249,12439,12688,1,52,12439,5528
26,249,12439,12688,-1,52,12688,13720
26,88,12688,12776,1,172,12688,5529
26,88,12688,12776,-1,172,12776,13721
26,86,12776,12862,1,230,12776,5530
26,86,12776,12862,-1,230,12862,13722
26,205,12862,13067,1,183,12862,5531
26,205,12862,13067,-1,183,13067,13723
26,79,13067,13146,1,243,13067,5532
26,79,13067,13146,-1,243,13146,13724
26,175,13146,13321,1,130,13146,5533
26,175,13146,13321,-1,130,13321,13725
26,173,13321,13494,1,203,13321,5534
26,173,13321,13494,-1,203,13494,13726
26,231,13494,13725,1,171,13494,5535
26,231,13494,13725,-1,171,13725,13727
26,246,13725,13971,1,90,13725,5536
26,246,13725,13971,-1,90,13971,13728
26,164,13971,14135,1,229,13971,5537
26,164,13971,14135,-1,229,14135,13729
26,244,14135,14379,1,16,14135,5538
26,244,14135,14379,-1,16,14379,13730
26,91,14379,14470,1,14,14379,5539
26,91,14379,14470,-1,14,14470,13731
26,145,14470,14615,1,150,14470,5540
26,145,14470,14615,-1,150,14615,13732
26,100,14615,14715,1,41,14615,5541
26,100,14615,14715,-1,41,14715,13733
26,123,14715,14838,1,18,14715,5542
26,123,14715,14838,-1,18,14838,13734
26,149,14838,14987,1,46,14838,5543
26,149,14838,14987,-1,46,14987,13735
26,219,14987,15206,1,245,14987,5544
26,219,14987,15206,-1,245,15206,13736
26,56,15206,15262,1,24,15206,5545
26,56,15206,15262,-1,24,15262,13737
26,151,15262,15413,1,222,15262,5546
26,151,15262,15413,-1,222,15413,13738
26,152,15413,15565,1,2,15413,5547
26,152,15413,15565,-1,2,15565,13739
26,131,15565,15696,1,16,15565,5548
26,131,15565,15696,-1,16,15696,13740
26,130,15696,15826,1,251,15696,5549
26,130,15696,15826,-1,251,15826,13741
26,120,15826,15946,1,151,15826,5550
26,120,15826,15946,-1,151,15946,13742
26,112,15946,16058,1,200,15946,5551
26,112,15946,16058,-1,200,16058,13743
26,91,16058,16149,1,138,16058,5552
26,91,16058,16149,-1,138,16149,13744
26,55,16149,16204,1,152,16149,5553
26,55,16149,16204,-1,152,16204,13745
26,109,16204,16313,1,64,16204,5554
26,109,16204,16313,-1,64,16313,13746
26,130,16313,16443,1,102,16313,5555
26,130,16313,16443,-1,102,16443,13747
26,147,16443,16590,1,245,16443,5556
26,147,16443,16590,-1,245,16590,13748
26,37,16590,16627,1,239,16590,5557
26,37,16590,16627,-1,239,16627,13749
26,54,16627,16681,1,182,16627,5558
26,54,16627,16681,-1,182,16681,13750
26,143,16681,16824,1,129,16681,5559
26,143,16681,16824,-1,129,16824,13751
26,195,16824,17019,1,204,16824,5560
26,195,16824,17019,-1,204,17019,13752
26,60,17019,17079,1,36,17019,5561
26,60,17019,17079,-1,36,17079,13753
26,82,17079,17161,1,238,17079,5562
26,82,17079,17161,-1,238,17161,13754
26,114,17161,17275,1,102,17161,5563
26,114,17161,17275,-1,102,17275,13755
26,227,17275,17502,1,184,17275,5564
26,227,17275,17502,-1,184,17502,13756
26,122,17502,17624,1,184,17502,5565
26,122,17502,17624,-1,184,17624,13757
26,135,17624,17759,1,85,17624,5566
26,135,17624,17759,-1,85,17759,13758
26,128,17759,17887,1,8,17759,5567
26,128,17759,17887,-1,8,17887,13759
26,134,17887,18021,1,60,17887,5568
26,134,17887,18021,-1,60,18021,13760
26,101,18021,18122,1,221,18021,5569
26,101,18021,18122,-1,221,18122,13761
26,74,18122,18196,1,133,18122,5570
26,74,18122,18196,-1,133,18196,13762
26,80,18196,18276,1,190,18196,5571
26,80,18196,18276,-1,190,18276,13763
26,113,18276,18389,1,107,18276,5572
26,113,18276,18389,-1,107,18389,13764
26,50,18389,18439,1,194,18389,5573
26,50,18389,18439,-1,194,18439,13765
26,117,18439,18556,1,60,18439,5574
26,117,18439,18556,-1,60,18556,13766
26,107,18556,18663,1,82,18556,5575
26,107,18556,18663,-1,82,18663,13767
26,116,18663,18779,1,211,18663,5576
26,116,18663,18779,-1,211,18779,13768
26,141,18779,18920,1,146,18779,5577
26,141,18779,18920,-1,146,18920,13769
26,74,18920,18994,1,34,18920,5578
26,74,18920,18994,-1,34,18994,13770
26,177,18994,19171,1,231,18994,5579
26,177,18994,19171,-1,231,19171,13771
26,45,19171,19216,1,196,19171,5580
26,45,19171,19216,-1,196,19216,13772
26,30,19216,19246,1,123,19216,5581
26,30,19216,19246,-1,123,19246,13773
26,37,19246,19283,1,199,19246,5582
26,37,19246,19283,-1,199,19283,13774
26,171,19283,19454,1,13,19283,5583
26,171,19283,19454,-1,13,19454,13775
26,69,19454,19523,1,187,19454,5584
26,69,19454,19523,-1,187,19523,13776
26,177,19523,19700,1,250,19523,5585
26,177,19523,19700,-1,250,19700,13777
26,93,19700,19793,1,161,19700,5586
26,93,19700,19793,-1,161,19793,13778
26,93,19793,19886,1,73,19793,5587
26,93,19793,19886,-1,73,19886,13779
26,91,19886,19977,1,172,19886,5588
26,91,19886,19977,-1,172,19977,13780
26,97,19977,20074,1,111,19977,5589
26,97,19977,20074,-1,111,20074,13781
26,115,20074,20189,1,74,20074,5590
26,115,20074,20189,-1,74,20189,13782
26,102,20189,20291,1,96,20189,5591
26,102,20189,20291,-1,96,20291,13783
26,151,20291,20442,1,125,20291,5592
26,151,20291,20442,-1,125,20442,13784
26,126,20442,20568,1,247,20442,5593
26,126,20442,20568,-1,247,20568,13785
26,209,20568,20777,1,177,20568,5594
26,209,20568,20777,-1,177,20777,13786
26,137,20777,20914,1,244,20777,5595
26,137,20777,20914,-1,244,20914,13787
26,163,20914,21077,1,2,20914,5596
26,163,20914,21077,-1,2,21077,13788
26,23,21077,21100,1,151,21077,5597
26,23,21077,21100,-1,151,21100,13789
26,178,21100,21278,1,30,21100,5598
26,178,21100,21278,-1,30,21278,13790
26,80,21278,21358,1,30,21278,5599
26,80,21278,21358,-1,30,21358,13791
26,56,21358,21414,1,137,21358,5600
26,56,21358,21414,-1,137,21414,13792
26,140,21414,21554,1,77,21414,5601
26,140,21414,21554,-1,77,21554,13793
26,261,21554,21815,1,104,21554,5602
26,261,21554,21815,-1,104,21815,13794
26,258,21815,22073,1,157,21815,5603
26,258,21815,22073,-1,157,22073,13795
26,182,22073,22255,1,67,22073,5604
26,182,22073,22255,-1,67,22255,13796
26,90,22255,22345,1,252,22255,5605
26,90,22255,22345,-1,252,22345,13797
26,155,22345,22500,1,137,22345,5606
26,155,22345,22500,-1,137,22500,13798
26,120,22500,22620,1,166,22500,5607
26,120,22500,22620,-1,166,22620,13799
26,103,22620,22723,1,87,22620,5608
26,103,22620,22723,-1,87,22723,13800
26,181,22723,22904,1,237,22723,5609
26,181,22723,22904,-1,237,22904,13801
26,63,22904,22967,1,42,22904,5610
26,63,22904,22967,-1,42,22967,13802
26,115,22967,23082,1,254,22967,5611
26,115,22967,23082,-1,254,23082,13803
26,101,23082,23183,1,254,23082,5612
26,101,23082,23183,-1,254,23183,13804
26,163,23183,23346,1,160,23183,5613
26,163,23183,23346,-1,160,23346,13805
26,72,23346,23418,1,215,23346,5614
26,72,23346,23418,-1,215,23418,13806
26,135,23418,23553,1,240,23418,5615
26,135,23418,23553,-1,240,23553,13807
26,88,23553,23641,1,122,23553,5616
26,88,23553,23641,-1,122,23641,13808
26,84,23641,23725,1,54,23641,5617
26,84,23641,23725,-1,54,23725,13809
26,151,23725,23876,1,71,23725,5618
26,151,23725,23876,-1,71,23876,13810
26,30,23876,23906,1,249,23876,5619
26,30,23876,23906,-1,249,23906,13811
26,38,23906,23944,1,224,23906,5620
26,38,23906,23944,-1,224,23944,13812
26,166,23944,24110,1,64,23944,5621
26,166,23944,24110,-1,64,24110,13813
26,62,24110,24172,1,147,24110,5622
26,62,24110,24172,-1,147,24172,13814
26,148,24172,24320,1,190,24172,5623
26,148,24172,24320,-1,190,24320,13815
26,307,24320,24627,1,19,24320,5624
26,307,24320,24627,-1,19,24627,13816
26,131,24627,24758,1,254,24627,5625
26,131,24627,24758,-1,254,24758,13817
26,78,24758,24836,1,30,24758,5626
26,78,24758,24836,-1,30,24836,13818
26,113,24836,24949,1,228,24836,5627
26,113,24836,24949,-1,228,24949,13819
26,174,24949,25123,1,158,24949,5628
26,174,24949,25123,-1,158,25123,13820
26,79,25123,25202,1,128,25123,5629
26,79,25123,25202,-1,128,25202,13821
26,63,25202,25265,1,164,25202,5630
26,63,25202,25265,-1,164,25265,13822
26,294,25265,25559,1,131,25265,5631
26,294,25265,25559,-1,131,25559,13823
26,66,25559,25625,1,142,25559,5632
26,66,25559,25625,-1,142,25625,13824
26,127,25625,25752,1,1,25625,5633
26,127,25625,25752,-1,1,25752,13825
26,132,25752,25884,1,247,25752,5634
26,132,25752,25884,-1,247,25884,13826
26,202,25884,26086,1,216,25884,5635
26,202,25884,26086,-1,216,26086,13827
26,79,26086,26165,1,226,26086,5636
26,79,26086,26165,-1,226,26165,13828
26,140,26165,26305,1,234,26165,5637
26,140,26165,26305,-1,234,26305,13829
26,120,26305,26425,1,193,26305,5638
26,120,26305,26425,-1,193,26425,13830
26,134,26425,26559,1,155,26425,5639
26,134,26425,26559,-1,155,26559,13831
26,47,26559,26606,1,77,26559,5640
26,47,26559,26606,-1,77,26606,13832
26,164,26606,26770,1,13,26606,5641
26,164,26606,26770,-1,13,26770,13833
26,96,26770,26866,1,109,26770,5642
26,96,26770,26866,-1,109,26866,13834
26,86,26866,26952,1,182,26866,5643
26,86,26866,26952,-1,182,26952,13835
26,87,26952,27039,1,95,26952,5644
26,87,26952,27039,-1,95,27039,13836
26,268,27039,27307,1,53,27039,5645
26,268,27039,27307,-1,53,27307,13837
26,142,27307,27449,1,66,27307,5646
26,142,27307,27449,-1,66,27449,13838
26,107,27449,27556,1,164,27449,5647
26,107,27449,27556,-1,164,27556,13839
26,145,27556,27701,1,140,27556,5648
26,145,27556,27701,-1,140,27701,13840
26,93,27701,27794,1,41,27701,5649
26,93,27701,27794,-1,41,27794,13841
26,98,27794,27892,1,134,27794,5650
26,98,27794,27892,-1,134,27892,13842
26,144,27892,28036,1,88,27892,5651
26,144,27892,28036,-1,88,28036,13843
26,52,28036,28088,1,170,28036,5652
26,52,28036,28088,-1,170,28088,13844
26,108,28088,28196,1,250,28088,5653
26,108,28088,28196,-1,250,28196,13845
26,119,28196,28315,1,227,28196,5654
26,119,28196,28315,-1,227,28315,13846
26,142,28315,28457,1,256,28315,5655
26,142,28315,28457,-1,256,28457,13847
26,120,28457,28577,1,19,28457,5656
26,120,28457,28577,-1,19,28577,13848
26,271,28577,28848,1,108,28577,5657
26,271,28577,28848,-1,108,28848,13849
26,80,28848,28928,1,99,28848,5658
26,80,28848,28928,-1,99,28928,13850
26,99,28928,29027,1,224,28928,5659
26,99,28928,29027,-1,224,29027,13851
26,202,29027,29229,1,97,29027,5660
26,202,29027,29229,-1,97,29229,13852
26,101,29229,29330,1,225,29229,5661
26,101,29229,29330,-1,225,29330,13853
26,102,29330,29432,1,249,29330,5662
26,102,29330,29432,-1,249,29432,13854
26,159,29432,29591,1,190,29432,5663
26,159,29432,29591,-1,190,29591,13855
26,165,29591,29756,1,158,29591,5664
26,165,29591,29756,-1,158,29756,13856
26,89,29756,29845,1,241,29756,5665
26,89,29756,29845,-1,241,29845,13857
26,120,29845,29965,1,191,29845,5666
26,120,29845,29965,-1,191,29965,13858
26,181,29965,30146,1,67,29965,5667
26,181,29965,30146,-1,67,30146,13859
26,104,30146,30250,1,247,30146,5668
26,104,30146,30250,-1,247,30250,13860
26,165,30250,30415,1,123,30250,5669
26,165,30250,30415,-1,123,30415,13861
26,290,30415,30705,1,44,30415,5670
26,290,30415,30705,-1,44,30705,13862
26,202,30705,30907,1,77,30705,5671
26,202,30705,30907,-1,77,30907,13863
26,225,30907,31132,1,93,30907,5672
26,225,30907,31132,-1,93,31132,13864
26,444,31132,31576,1,156,31132,5673
26,444,31132,31576,-1,156,31576,13865
26,115,31576,31691,1,97,31576,5674
26,115,31576,31691,-1,97,31691,13866
27,127,0,127,1,255,0,2309
27,127,0,127,-1,255,127,10501
27,78,127,205,1,12,127,2310
27,78,127,205,-1,12,205,10502
27,110,205,315,1,64,205,2311
27,110,205,315,-1,64,315,10503
27,161,315,476,1,69,315,2312
27,161,315,476,-1,69,476,10504
27,175,476,651,1,84,476,2313
27,175,476,651,-1,84,651,10505
27,105,651,756,1,133,651,2314
27,105,651,756,-1,133,756,10506
27,42,756,798,1,142,756,2315
27,42,756,798,-1,142,798,10507
27,209,798,1007,1,240,798,2316
27,209,798,1007,-1,240,1007,10508
27,132,1007,1139,1,213,1007,2317
27,132,1007,1139,-1,213,1139,10509
27,60,1139,1199,1,156,1139,2318
27,60,1139,1199,-1,156,1199,10510
27,119,1199,1318,1,252,1199,2319
27,119,1199,1318,-1,252,1318,10511
27,97,1318,1415,1,104,1318,2320
27,97,1318,1415,-1,104,1415,10512
27,71,1415,1486,1,193,1415,2321
27,71,1415,1486,-1,193,1486,10513
27,111,1486,1597,1,190,1486,2322
27,111,1486,1597,-1,190,1597,10514
27,93,1597,1690,1,8,1597,2323
27,93,1597,1690,-1,8,1690,10515
27,259,1690,1949,1,94,1690,2324
27,259,1690,1949,-1,94,1949,10516
27,162,1949,2111,1,142,1949,2325
27,162,1949,2111,-1,142,2111,10517
27,139,2111,2250,1,217,2111,2326
27,139,2111,2250,-1,217,2250,10518
27,142,2250,2392,1,140,2250,2327
27,142,2250,2392,-1,140,2392,10519
27,73,2392,2465,1,234,2392,2328
27,73,2392,2465,-1,234,2465,10520
27,91,2465,2556,1,125,2465,2329
27,91,2465,2556,-1,125,2556,10521
27,163,2556,2719,1,35,2556,2330
27,163,2556,2719,-1,35,2719,10522
27,161,2719,2880,1,156,2719,2331
27,161,2719,2880,-1,156,2880,10523
27,143,2880,3023,1,79,2880,2332
27,143,2880,3023,-1,79,3023,10524
27,111,3023,3134,1,74,3023,2333
27,111,3023,3134,-1,74,3134,10525
27,48,3134,3182,1,79,3134,2334
27,48,3134,3182,-1,79,3182,10526
27,63,3182,3245,1,160,3182,2335
27,63,3182,3245,-1,160,3245,10527
27,249,3245,3494,1,147,3245,2336
27,249,3245,3494,-1,147,3494,10528
27,123,3494,3617,1,222,3494,2337
27,123,3494,3617,-1,222,3617,10529
27,58,3617,3675,1,44,3617,2338
27,58,3617,3675,-1,44,3675,10530
27,148,3675,3823,1,114,3675,2339
27,148,3675,3823,-1,114,3823,10531
27,88,3823,3911,1,165,3823,2340
27,88,3823,3911,-1,165,3911,10532
27,67,3911,3978,1,226,3911,2341
27,67,3911,3978,-1,226,3978,10533
27,34,3978,4012,1,4,3978,2342
27,34,3978,4012,-1,4,4012,10534
27,62,4012,4074,1,41,4012,2343
27,62,4012,4074,-1,41,4074,10535
27,168,4074,4242,1,124,4074,2344
27,168,4074,4242,-1,124,4242,10536
27,188,4242,4430,1,125,4242,2345
27,188,4242,4430,-1,125,4430,10537
27,87,4430,4517,1,217,4430,2346
27,87,4430,4517,-1,217,4517,10538
27,151,4517,4668,1,88,4517,2347
27,151,4517,4668,-1,88,4668,10539
27,141,4668,4809,1,13,4668,2348
27,141,4668,4809,-1,13,4809,10540
27,233,4809,5042,1,190,4809,2349
27,233,4809,5042,-1,190,5042,10541
27,134,5042,5176,1,18,5042,2350
27,134,5042,5176,-1,18,5176,10542
27,92,5176,5268,1,135,5176,2351
27,92,5176,5268,-1,135,5268,10543
27,179,5268,5447,1,185,5268,2352
27,179,5268,5447,-1,185,5447,10544
27,138,5447,5585,1,221,5447,2353
27,138,5447,5585,-1,221,5585,10545
27,28,5585,5613,1,195,5585,2354
27,28,5585,5613,-1,195,5613,10546
27,50,5613,5663,1,37,5613,2355
27,50,5613,5663,-1,37,5663,10547
27,94,5663,5757,1,119,5663,2356
27,94,5663,5757,-1,119,5757,10548
27,115,5757,5872,1,209,5757,2357
27,115,5757,5872,-1,209,5872,10549
27,220,5872,6092,1,247,5872,2358
27,220,5872,6092,-1,247,6092,10550
27,130,6092,6222,1,89,6092,2359
27,130,6092,6222,-1,89,6222,10551
27,56,6222,6278,1,184,6222,2360
27,56,6222,6278,-1,184,6278,10552
27,113,6278,6391,1,72,6278,2361
27,113,6278,6391,-1,72,6391,10553
27,92,6391,6483,1,45,6391,2362
27,92,6391,6483,-1,45,6483,10554
27,249,6483,6732,1,196,6483,2363
27,249,6483,6732,-1,196,6732,10555
27,123,6732,6855,1,256,6732,2364
27,123,6732,6855,-1,256,6855,10556
27,174,6855,7029,1,11,6855,2365
27,174,6855,7029,-1,11,7029,10557
27,306,7029,7335,1,48,7029,2366
27,306,7029,7335,-1,48,7335,10558
27,75,7335,7410,1,74,7335,2367
27,75,7335,7410,-1,74,7410,10559
27,74,7410,7484,1,82,7410,2368
27,74,7410,7484,-1,82,7484,10560
27,124,7484,7608,1,69,7484,2369
27,124,7484,7608,-1,69,7608,10561
27,202,7608,7810,1,92,7608,2370
27,202,7608,7810,-1,92,7810,10562
27,251,7810,8061,1,232,7810,2371
27,251,7810,8061,-1,232,8061,10563
27,134,8061,8195,1,64,8061,2372
27,134,8061,8195,-1,64,8195,10564
27,92,8195,8287,1,81,8195,2373
27,92,8195,8287,-1,81,8287,10565
27,46,8287,8333,1,48,8287,2374
27,46,8287,8333,-1,48,8333,10566
27,94,8333,8427,1,225,8333,2375
27,94,8333,8427,-1,225,8427,10567
27,84,8427,8511,1,186,8427,2376
27,84,8427,8511,-1,186,8511,10568
27,49,8511,8560,1,217,8511,2377
27,49,8511,8560,-1,217,8560,10569
27,34,8560,8594,1,215,8560,2378
27,34,8560,8594,-1,215,8594,10570
27,203,8594,8797,1,60,8594,2379
27,203,8594,8797,-1,60,8797,10571
27,223,8797,9020,1,225,8797,2380
27,223,8797,9020,-1,225,9020,10572
27,159,9020,9179,1,80,9020,2381
27,159,9020,9179,-1,80,9179,10573
27,123,9179,9302,1,150,9179,2382
27,123,9179,9302,-1,150,9302,10574
27,144,9302,9446,1,10,9302,2383
27,144,9302,9446,-1,10,9446,10575
27,295,9446,9741,1,129,9446,2384
27,295,9446,9741,-1,129,9741,10576
27,67,9741,9808,1,205,9741,2385
27,67,9741,9808,-1,205,9808,10577
27,285,9808,10093,1,57,9808,2386
27,285,9808,10093,-1,57,10093,10578
27,152,10093,10245,1,225,10093,2387
27,152,10093,10245,-1,225,10245,10579
27,50,10245,10295,1,2,10245,2388
27,50,10245,10295,-1,2,10295,10580
27,89,10295,10384,1,75,10295,2389
27,89,10295,10384,-1,75,10384,10581
27,144,10384,10528,1,237,10384,2390
27,144,10384,10528,-1,237,10528,10582
27,99,10528,10627,1,93,10528,2391
27,99,10528,10627,-1,93,10627,10583
27,40,10627,10667,1,207,10627,2392
27,40,10627,10667,-1,207,10667,10584
27,206,10667,10873,1,252,10667,2393
27,206,10667,10873,-1,252,10873,10585
27,117,10873,10990,1,154,10873,2394
27,117,10873,10990,-1,154,10990,10586
27,107,10990,11097,1,11,10990,2395
27,107,10990,11097,-1,11,11097,10587
27,334,11097,11431,1,184,11097,2396
27,334,11097,11431,-1,184,11431,10588
27,51,11431,11482,1,76,11431,2397
27,51,11431,11482,-1,76,11482,10589
27,160,11482,11642,1,143,11482,2398
27,160,11482,11642,-1,143,11642,10590
27,127,11642,11769,1,137,11642,2399
27,127,11642,11769,-1,137,11769,10591
27,109,11769,11878,1,236,11769,2400
27,109,11769,11878,-1,236,11878,10592
27,187,11878,12065,1,2,11878,2401
27,187,11878,12065,-1,2,12065,10593
27,123,12065,12188,1,93,12065,2402
27,123,12065,12188,-1,93,12188,10594
27,185,12188,12373,1,17,12188,2403
27,185,12188,12373,-1,17,12373,10595
27,104,12373,12477,1,132,12373,2404
27,104,12373,12477,-1,132,12477,10596
27,249,12477,12726,1,99,12477,2405
27,249,12477,12726,-1,99,12726,10597
27,112,12726,12838,1,240,12726,2406
27,112,12726,12838,-1,240,12838,10598
27,193,12838,13031,1,27,12838,2407
27,193,12838,13031,-1,27,13031,10599
27,141,13031,13172,1,113,13031,2408
27,141,13031,13172,-1,113,13172,10600
27,64,13172,13236,1,75,13172,2409
27,64,13172,13236,-1,75,13236,10601
27,196,13236,13432,1,161,13236,2410
27,196,13236,13432,-1,161,13432,10602
27,82,13432,13514,1,25,13432,2411
27,82,13432,13514,-1,25,13514,10603
27,99,13514,13613,1,103,13514,2412
27,99,13514,13613,-1,103,13613,10604
27,170,13613,13783,1,97,13613,2413
27,170,13613,13783,-1,97,13783,10605
27,102,13783,13885,1,202,13783,2414
27,102,13783,13885,-1,202,13885,10606
27,245,13885,14130,1,115,13885,2415
27,245,13885,14130,-1,115,14130,10607
27,210,14130,14340,1,230,14130,2416
27,210,14130,14340,-1,230,14340,10608
27,119,14340,14459,1,205,14340,2417
27,119,14340,14459,-1,205,14459,10609
27,143,14459,14602,1,36,14459,2418
27,143,14459,14602,-1,36,14602,10610
27,171,14602,14773,1,49,14602,2419
27,171,14602,14773,-1,49,14773,10611
27,150,14773,14923,1,199,14773,2420
27,150,14773,14923,-1,199,14923,10612
27,146,14923,15069,1,149,14923,2421
27,146,14923,15069,-1,149,15069,10613
27,131,15069,15200,1,9,15069,2422
27,131,15069,15200,-1,9,15200,10614
27,148,15200,15348,1,150,15200,2423
27,148,15200,15348,-1,150,15348,10615
27,68,15348,15416,1,193,15348,2424
27,68,15348,15416,-1,193,15416,10616
27,131,15416,15547,1,14,15416,2425
27,131,15416,15547,-1,14,15547,10617
27,133,15547,15680,1,65,15547,2426
27,133,15547,15680,-1,65,15680,10618
27,208,15680,15888,1,49,15680,2427
27,208,15680,15888,-1,49,15888,10619
27,109,15888,15997,1,124,15888,2428
27,109,15888,15997,-1,124,15997,10620
27,56,15997,16053,1,222,15997,2429
27,56,15997,16053,-1,222,16053,10621
27,122,16053,16175,1,121,16053,2430
27,122,16053,16175,-1,121,16175,10622
27,119,16175,16294,1,220,16175,2431
27,119,16175,16294,-1,220,16294,10623
27,130,16294,16424,1,164,16294,2432
27,130,16294,16424,-1,164,16424,10624
27,133,16424,16557,1,163,16424,2433
27,133,16424,16557,-1,163,16557,10625
27,82,16557,16639,1,164,16557,2434
27,82,16557,16639,-1,164,16639,10626
27,70,16639,16709,1,236,16639,2435
27,70,16639,16709,-1,236,16709,10627
27,56,16709,16765,1,26,16709,2436
27,56,16709,16765,-1,26,16765,10628
27,112,16765,16877,1,16,16765,2437
27,112,16765,16877,-1,16,16877,10629
27,167,16877,17044,1,64,16877,2438
27,167,16877,17044,-1,64,17044,10630
27,118,17044,17162,1,99,17044,2439
27,118,17044,17162,-1,99,17162,10631
27,159,17162,17321,1,108,17162,2440
27,159,17162,17321,-1,108,17321,10632
27,81,17321,17402,1,206,17321,2441
27,81,17321,17402,-1,206,17402,10633
27,216,17402,17618,1,196,17402,2442
27,216,17402,17618,-1,196,17618,10634
27,39,17618,17657,1,148,17618,2443
27,39,17618,17657,-1,148,17657,10635
27,141,17657,17798,1,247,17657,2444
27,141,17657,17798,-1,247,17798,10636
27,215,17798,18013,1,72,17798,2445
27,215,17798,18013,-1,72,18013,10637
27,215,18013,18228,1,193,18013,2446
27,215,18013,18228,-1,193,18228,10638
27,158,18228,18386,1,212,18228,2447
27,158,18228,18386,-1,212,18386,10639
27,52,18386,18438,1,22,18386,2448
27,52,18386,18438,-1,22,18438,10640
27,122,18438,18560,1,154,18438,2449
27,122,18438,18560,-1,154,18560,10641
27,40,18560,18600,1,50,18560,2450
27,40,18560,18600,-1,50,18600,10642
27,37,18600,18637,1,173,18600,2451
27,37,18600,18637,-1,173,18637,10643
27,109,18637,18746,1,155,18637,2452
27,109,18637,18746,-1,155,18746,10644
27,80,18746,18826,1,27,18746,2453
27,80,18746,18826,-1,27,18826,10645
27,147,18826,18973,1,238,18826,2454
27,147,18826,18973,-1,238,18973,10646
27,100,18973,19073,1,213,18973,2455
27,100,18973,19073,-1,213,19073,10647
27,118,19073,19191,1,52,19073,2456
27,118,19073,19191,-1,52,19191,10648
27,82,19191,19273,1,232,19191,2457
27,82,19191,19273,-1,232,19273,10649
27,58,19273,19331,1,67,19273,2458
27,58,19273,19331,-1,67,19331,10650
27,142,19331,19473,1,84,19331,2459
27,142,19331,19473,-1,84,19473,10651
27,124,19473,19597,1,10,19473,2460
27,124,19473,19597,-1,10,19597,10652
27,111,19597,19708,1,245,19597,2461
27,111,19597,19708,-1,245,19708,10653
27,76,19708,19784,1,197,19708,2462
27,76,19708,19784,-1,197,19784,10654
27,71,19784,19855,1,18,19784,2463
27,71,19784,19855,-1,18,19855,10655
27,187,19855,20042,1,161,19855,2464
27,187,19855,20042,-1,161,20042,10656
27,170,20042,20212,1,211,20042,2465
27,170,20042,20212,-1,211,20212,10657
27,321,20212,20533,1,185,20212,2466
27,321,20212,20533,-1,185,20533,10658
27,178,20533,20711,1,104,20533,2467
27,178,20533,20711,-1,104,20711,10659
27,160,20711,20871,1,76,20711,2468
27,160,20711,20871,-1,76,20871,10660
27,151,20871,21022,1,193,20871,2469
27,151,20871,21022,-1,193,21022,10661
27,24,21022,21046,1,96,21022,2470
27,24,21022,21046,-1,96,21046,10662
27,205,21046,21251,1,249,21046,2471
27,205,21046,21251,-1,249,21251,10663
27,325,21251,21576,1,107,21251,2472
27,325,21251,21576,-1,107,21576,10664
27,152,21576,21728,1,99,21576,2473
27,152,21576,21728,-1,99,21728,10665
27,54,21728,21782,1,123,21728,2474
27,54,21728,21782,-1,123,21782,10666
27,85,21782,21867,1,16,21782,2475
27,85,21782,21867,-1,16,21867,10667
27,45,21867,21912,1,1,21867,2476
27,45,21867,21912,-1,1,21912,10668
27,63,21912,21975,1,234,21912,2477
27,63,21912,21975,-1,234,21975,10669
27,89,21975,22064,1,85,21975,2478
27,89,21975,22064,-1,85,22064,10670
27,128,22064,22192,1,241,22064,2479
27,128,22064,22192,-1,241,22192,10671
27,130,22192,22322,1,186,22192,2480
27,130,22192,22322,-1,186,22322,10672
27,157,22322,22479,1,182,22322,2481
27,157,22322,22479,-1,182,22479,10673
27,109,22479,22588,1,58,22479,2482
27,109,22479,22588,-1,58,22588,10674
27,232,22588,22820,1,109,22588,2483
27,232,22588,22820,-1,109,22820,10675
27,159,22820,22979,1,211,22820,2484
27,159,22820,22979,-1,211,22979,10676
27,184,22979,23163,1,217,22979,2485
27,184,22979,23163,-1,217,23163,10677
27,75,23163,23238,1,27,23163,2486
27,75,23163,23238,-1,27,23238,10678
27,81,23238,23319,1,86,23238,2487
27,81,23238,23319,-1,86,23319,10679
27,231,23319,23550,1,106,23319,2488
27,231,23319,23550,-1,106,23550,10680
27,112,23550,23662,1,3,23550,2489
27,112,23550,23662,-1,3,23662,10681
27,31,23662,23693,1,61,23662,2490
27,31,23662,23693,-1,61,23693,10682
27,71,23693,23764,1,109,23693,2491
27,71,23693,23764,-1,109,23764,10683
27,114,23764,23878,1,153,23764,2492
27,114,23764,23878,-1,153,23878,10684
27,120,23878,23998,1,193,23878,2493
27,120,23878,23998,-1,193,23998,10685
27,58,23998,24056,1,186,23998,2494
27,58,23998,24056,-1,186,24056,10686
27,74,24056,24130,1,86,24056,2495
27,74,24056,24130,-1,86,24130,10687
27,191,24130,24321,1,56,24130,2496
27,191,24130,24321,-1,56,24321,10688
27,101,24321,24422,1,36,24321,2497
27,101,24321,24422,-1,36,24422,10689
27,65,24422,24487,1,189,24422,2498
27,65,24422,24487,-1,189,24487,10690
27,111,24487,24598,1,102,24487,2499
27,111,24487,24598,-1,102,24598,10691
27,71,24598,24669,1,207,24598,2500
27,71,24598,24669,-1,207,24669,10692
27,65,24669,24734,1,161,24669,2501
27,65,24669,24734,-1,161,24734,10693
27,100,24734,24834,1,205,24734,2502
27,100,24734,24834,-1,205,24834,10694
27,256,24834,25090,1,82,24834,2503
27,256,24834,25090,-1,82,25090,10695
27,194,25090,25284,1,1,25090,2504
27,194,25090,25284,-1,1,25284,10696
27,122,25284,25406,1,77,25284,2505
27,122,25284,25406,-1,77,25406,10697
27,106,25406,25512,1,192,25406,2506
27,106,25406,25512,-1,192,25512,10698
27,237,25512,25749,1,195,25512,2507
27,237,25512,25749,-1,195,25749,10699
27,242,25749,25991,1,3,25749,2508
27,242,25749,25991,-1,3,25991,10700
27,176,25991,26167,1,35,25991,2509
27,176,25991,26167,-1,35,26167,10701
27,237,26167,26404,1,254,26167,2510
27,237,26167,26404,-1,254,26404,10702
27,117,26404,26521,1,1,26404,2511
27,117,26404,26521,-1,1,26521,10703
27,107,26521,26628,1,121,26521,2512
27,107,26521,26628,-1,121,26628,10704
27,100,26628,26728,1,185,26628,2513
27,100,26628,26728,-1,185,26728,10705
27,139,26728,26867,1,56,26728,2514
27,139,26728,26867,-1,56,26867,10706
27,67,26867,26934,1,32,26867,2515
27,67,26867,26934,-1,32,26934,10707
27,65,26934,26999,1,140,26934,2516
27,65,26934,26999,-1,140,26999,10708
27,159,26999,27158,1,127,26999,2517
27,159,26999,27158,-1,127,27158,10709
27,146,27158,27304,1,9,27158,2518
27,146,27158,27304,-1,9,27304,10710
27,160,27304,27464,1,67,27304,2519
27,160,27304,27464,-1,67,27464,10711
27,122,27464,27586,1,38,27464,2520
27,122,27464,27586,-1,38,27586,10712
27,253,27586,27839,1,75,27586,2521
27,253,27586,27839,-1,75,27839,10713
27,32,27839,27871,1,94,27839,2522
27,32,27839,27871,-1,94,27871,10714
27,109,27871,27980,1,31,27871,2523
27,109,27871,27980,-1,31,27980,10715
27,162,27980,28142,1,239,27980,2524
27,162,27980,28142,-1,239,28142,10716
27,69,28142,28211,1,28,28142,2525
27,69,28142,28211,-1,28,28211,10717
27,51,28211,28262,1,148,28211,2526
27,51,28211,28262,-1,148,28262,10718
27,205,28262,28467,1,52,28262,2527
27,205,28262,28467,-1,52,28467,10719
27,36,28467,28503,1,100,28467,2528
27,36,28467,28503,-1,100,28503,10720
27,65,28503,28568,1,45,28503,2529
27,65,28503,28568,-1,45,28568,10721
27,96,28568,28664,1,77,28568,2530
27,96,28568,28664,-1,77,28664,10722
27,213,28664,28877,1,126,28664,2531
27,213,28664,28877,-1,126,28877,10723
27,67,28877,28944,1,225,28877,2532
27,67,28877,28944,-1,225,28944,10724
27,321,28944,29265,1,62,28944,2533
27,321,28944,29265,-1,62,29265,10725
27,120,29265,29385,1,252,29265,2534
27,120,29265,29385,-1,252,29385,10726
27,189,29385,29574,1,193,29385,2535
27,189,29385,29574,-1,193,29574,10727
27,71,29574,29645,1,152,29574,2536
27,71,29574,29645,-1,152,29645,10728
27,152,29645,29797,1,12,29645,2537
27,152,29645,29797,-1,12,29797,10729
27,79,29797,29876,1,37,29797,2538
27,79,29797,29876,-1,37,29876,10730
27,106,29876,29982,1,150,29876,2539
27,106,29876,29982,-1,150,29982,10731
27,142,29982,30124,1,194,29982,2540
27,142,29982,30124,-1,194,30124,10732
27,54,30124,30178,1,30,30124,2541
27,54,30124,30178,-1,30,30178,10733
27,60,30178,30238,1,99,30178,2542
27,60,30178,30238,-1,99,30238,10734
27,134,30238,30372,1,100,30238,2543
27,134,30238,30372,-1,100,30372,10735
27,89,30372,30461,1,24,30372,2544
27,89,30372,30461,-1,24,30461,10736
27,50,30461,30511,1,184,30461,2545
27,50,30461,30511,-1,184,30511,10737
27,133,30511,30644,1,80,30511,2546
27,133,30511,30644,-1,80,30644,10738
27,75,30644,30719,1,152,30644,2547
27,75,30644,30719,-1,152,30719,10739
27,68,30719,30787,1,251,30719,2548
27,68,30719,30787,-1,251,30787,10740
27,99,30787,30886,1,222,30787,2549
27,99,30787,30886,-1,222,30886,10741
27,63,30886,30949,1,32,30886,2550
27,63,30886,30949,-1,32,30949,10742
27,142,30949,31091,1,235,30949,2551
27,142,30949,31091,-1,235,31091,10743
27,91,31091,31182,1,9,31091,2552
27,91,31091,31182,-1,9,31182,10744
27,140,31182,31322,1,80,31182,2553
27,140,31182,31322,-1,80,31322,10745
27,108,31322,31430,1,45,31322,2554
27,108,31322,31430,-1,45,31430,10746
27,46,31430,31476,1,132,31430,2555
27,46,31430,31476,-1,132,31476,10747
27,65,31476,31541,1,91,31476,2556
27,65,31476,31541,-1,91,31541,10748
27,84,31541,31625,1,109,31541,2557
27,84,31541,31625,-1,109,31625,10749
27,188,31625,31813,1,114,31625,2558
27,188,31625,31813,-1,114,31813,10750
27,106,31813,31919,1,254,31813,2559
27,106,31813,31919,-1,254,31919,10751
27,153,31919,32072,1,49,31919,2560
27,153,31919,32072,-1,49,32072,10752
27,189,32072,32261,1,87,32072,2561
27,189,32072,32261,-1,87,32261,10753
27,176,32261,32437,1,47,32261,2562
27,176,32261,32437,-1,47,32437,10754
27,118,32437,32555,1,223,32437,2563
27,118,32437,32555,-1,223,32555,10755
27,152,32555,32707,1,78,32555,2564
27,152,32555,32707,-1,78,32707,10756
27,153,32707,32860,1,55,32707,2565
27,153,32707,32860,-1,55,32860,10757
27,109,32860,32969,1,132,32860,2566
27,109,32860,32969,-1,132,32969,10758
27,83,32969,33052,1,200,32969,2567
27,83,32969,33052,-1,200,33052,10759
27,171,33052,33223,1,77,33052,2568
27,171,33052,33223,-1,77,33223,10760
27,147,33223,33370,1,215,33223,2569
27,147,33223,33370,-1,215,33370,10761
27,156,33370,33526,1,26,33370,2570
27,156,33370,33526,-1,26,33526,10762
27,105,33526,33631,1,31,33526,2571
27,105,33526,33631,-1,31,33631,10763
27,132,33631,33763,1,111,33631,2572
27,132,33631,33763,-1,111,33763,10764
27,60,33763,33823,1,37,33763,2573
27,60,33763,33823,-1,37,33823,10765
27,165,33823,33988,1,159,33823,2574
27,165,33823,33988,-1,159,33988,10766
27,109,33988,34097,1,49,33988,2575
27,109,33988,34097,-1,49,34097,10767
28,97,0,97,1,158,0,4642
28,97,0,97,-1,158,97,12834
28,96,97,193,1,188,97,4643
28,96,97,193,-1,188,193,12835
28,97,193,290,1,75,193,4644
28,97,193,290,-1,75,290,12836
28,100,290,390,1,99,290,4645
28,100,290,390,-1,99,390,12837
28,70,390,460,1,160,390,4646
28,70,390,460,-1,160,460,12838
28,268,460,728,1,256,460,4647
28,268,460,728,-1,256,728,12839
28,193,728,921,1,37,728,4648
28,193,728,921,-1,37,921,12840
28,96,921,1017,1,251,921,4649
28,96,921,1017,-1,251,1017,12841
28,88,1017,1105,1,51,1017,4650
28,88,1017,1105,-1,51,1105,12842
28,136,1105,1241,1,141,1105,4651
28,136,1105,1241,-1,141,1241,12843
28,32,1241,1273,1,102,1241,4652
28,32,1241,1273,-1,102,1273,12844
28,56,1273,1329,1,216,1273,4653
28,56,1273,1329,-1,216,1329,12845
28,90,1329,1419,1,59,1329,4654
28,90,1329,1419,-1,59,1419,12846
28,55,1419,1474,1,6,1419,4655
28,55,1419,1474,-1,6,1474,12847
28,179,1474,1653,1,116,1474,4656
28,179,1474,1653,-1,116,1653,12848
28,280,1653,1933,1,154,1653,4657
28,280,1653,1933,-1,154,1933,12849
28,85,1933,2018,1,57,1933,4658
28,85,1933,2018,-1,57,2018,12850
28,112,2018,2130,1,224,2018,4659
28,112,2018,2130,-1,224,2130,12851
28,229,2130,2359,1,252,2130,4660
28,229,2130,2359,-1,252,2359,12852
28,139,2359,2498,1,193,2359,4661
28,139,2359,2498,-1,193,2498,12853
28,138,2498,2636,1,26,2498,4662
28,138,2498,2636,-1,26,2636,12854
28,103,2636,2739,1,127,2636,4663
28,103,2636,2739,-1,127,2739,12855
28,84,2739,2823,1,202,2739,4664
28,84,2739,2823,-1,202,2823,12856
28,236,2823,3059,1,251,2823,4665
28,236,2823,3059,-1,251,3059,12857
28,56,3059,3115,1,44,3059,4666
28,56,3059,3115,-1,44,3115,12858
28,214,3115,3329,1,159,3115,4667
28,214,3115,3329,-1,159,3329,12859
28,95,3329,3424,1,134,3329,4668
28,95,3329,3424,-1,134,3424,12860
28,131,3424,3555,1,119,3424,4669
28,131,3424,3555,-1,119,3555,12861
28,103,3555,3658,1,127,3555,4670
28,103,3555,3658,-1,127,3658,12862
28,146,3658,3804,1,236,3658,4671
28,146,3658,3804,-1,236,3804,12863
28,166,3804,3970,1,233,3804,4672
28,166,3804,3970,-1,233,3970,12864
28,34,3970,4004,1,49,3970,4673
28,34,3970,4004,-1,49,4004,12865
28,197,4004,4201,1,6,4004,4674
28,197,4004,4201,-1,6,4201,12866
28,277,4201,4478,1,164,4201,4675
28,277,4201,4478,-1,164,4478,12867
28,163,4478,4641,1,234,4478,4676
28,163,4478,4641,-1,234,4641,12868
28,115,4641,4756,1,228,4641,4677
28,115,4641,4756,-1,228,4756,12869
28,53,4756,4809,1,207,4756,4678
28,53,4756,4809,-1,207,4809,12870
28,102,4809,4911,1,1,4809,4679
28,102,4809,4911,-1,1,4911,12871
28,234,4911,5145,1,229,4911,4680
28,234,4911,5145,-1,229,5145,12872
28,85,5145,5230,1,114,5145,4681
28,85,5145,5230,-1,114,5230,12873
28,113,5230,5343,1,76,5230,4682
28,113,5230,5343,-1,76,5343,12874
28,68,5343,5411,1,186,5343,4683
28,68,5343,5411,-1,186,5411,12875
28,128,5411,5539,1,82,5411,4684
28,128,5411,5539,-1,82,5539,12876
28,190,5539,5729,1,102,5539,4685
28,190,5539,5729,-1,102,5729,12877
28,65,5729,5794,1,210,5729,4686
28,65,5729,5794,-1,210,5794,12878
28,97,5794,5891,1,224,5794,4687
28,97,5794,5891,-1,224,5891,12879
28,86,5891,5977,1,192,5891,4688
28,86,5891,5977,-1,192,5977,12880
28,132,5977,6109,1,28,5977,4689
28,132,5977,6109,-1,28,6109,12881
28,232,6109,6341,1,3,6109,4690
28,232,6109,6341,-1,3,6341,12882
28,74,6341,6415,1,96,6341,4691
28,74,6341,6415,-1,96,6415,12883
28,44,6415,6459,1,50,6415,4692
28,44,6415,6459,-1,50,6459,12884
28,78,6459,6537,1,82,6459,4693
28,78,6459,6537,-1,82,6537,12885
28,47,6537,6584,1,170,6537,4694
28,47,6537,6584,-1,170,6584,12886
28,125,6584,6709,1,79,6584,4695
28,125,6584,6709,-1,79,6709,12887
28,89,6709,6798,1,161,6709,4696
28,89,6709,6798,-1,161,6798,12888
28,97,6798,6895,1,145,6798,4697
28,97,6798,6895,-1,145,6895,12889
28,107,6895,7002,1,145,6895,4698
28,107,6895,7002,-1,145,7002,12890
28,156,7002,7158,1,14,7002,4699
28,156,7002,7158,-1,14,7158,12891
28,163,7158,7321,1,187,7158,4700
28,163,7158,7321,-1,187,7321,12892
28,96,7321,7417,1,16,7321,4701
28,96,7321,7417,-1,16,7417,12893
28,167,7417,7584,1,98,7417,4702
28,167,7417,7584,-1,98,7584,12894
28,170,7584,7754,1,136,7584,4703
28,170,7584,7754,-1,136,7754,12895
28,94,7754,7848,1,66,7754,4704
28,94,7754,7848,-1,66,7848,12896
28,34,7848,7882,1,84,7848,4705
28,34,7848,7882,-1,84,7882,12897
28,75,7882,7957,1,116,7882,4706
28,75,7882,7957,-1,116,7957,12898
28,301,7957,8258,1,236,7957,4707
28,301,7957,8258,-1,236,8258,12899
28,110,8258,8368,1,80,8258,4708
28,110,8258,8368,-1,80,8368,12900
28,237,8368,8605,1,177,8368,4709
28,237,8368,8605,-1,177,8605,12901
28,114,8605,8719,1,110,8605,4710
28,114,8605,8719,-1,110,8719,12902
28,63,8719,8782,1,161,8719,4711
28,63,8719,8782,-1,161,8782,12903
28,78,8782,8860,1,176,8782,4712
28,78,8782,8860,-1,176,8860,12904
28,109,8860,8969,1,99,8860,4713
28,109,8860,8969,-1,99,8969,12905
28,184,8969,9153,1,34,8969,4714
28,184,8969,9153,-1,34,9153,12906
28,187,9153,9340,1,237,9153,4715
28,187,9153,9340,-1,237,9340,12907
28,195,9340,9535,1,171,9340,4716
28,195,9340,9535,-1,171,9535,12908
28,99,9535,9634,1,209,9535,4717
28,99,9535,9634,-1,209,9634,12909
28,99,9634,9733,1,129,9634,4718
28,99,9634,9733,-1,129,9733,12910
28,64,9733,9797,1,225,9733,4719
28,64,9733,9797,-1,225,9797,12911
28,47,9797,9844,1,106,9797,4720
28,47,9797,9844,-1,106,9844,12912
28,54,9844,9898,1,203,9844,4721
28,54,9844,9898,-1,203,9898,12913
28,89,9898,9987,1,197,9898,4722
28,89,9898,9987,-1,197,9987,12914
28,117,9987,10104,1,121,9987,4723
28,117,9987,10104,-1,121,10104,12915
28,76,10104,10180,1,15,10104,4724
28,76,10104,10180,-1,15,10180,12916
28,122,10180,10302,1,93,10180,4725
28,122,10180,10302,-1,93,10302,12917
28,109,10302,10411,1,162,10302,4726
28,109,10302,10411,-1,162,10411,12918
28,95,10411,10506,1,253,10411,4727
28,95,10411,10506,-1,253,10506,12919
28,215,10506,10721,1,44,10506,4728
28,215,10506,10721,-1,44,10721,12920
28,102,10721,10823,1,226,10721,4729
28,102,10721,10823,-1,226,10823,12921
28,120,10823,10943,1,145,10823,4730
28,120,10823,10943,-1,145,10943,12922
28,108,10943,11051,1,224,10943,4731
28,108,10943,11051,-1,224,11051,12923
28,120,11051,11171,1,227,11051,4732
28,120,11051,11171,-1,227,11171,12924
28,259,11171,11430,1,62,11171,4733
28,259,11171,11430,-1,62,11430,12925
28,82,11430,11512,1,202,11430,4734
28,82,11430,11512,-1,202,11512,12926
28,91,11512,11603,1,132,11512,4735
28,91,11512,11603,-1,132,11603,12927
28,93,11603,11696,1,136,11603,4736
28,93,11603,11696,-1,136,11696,12928
28,94,11696,11790,1,156,11696,4737
28,94,11696,11790,-1,156,11790,12929
28,204,11790,11994,1,228,11790,4738
28,204,11790,11994,-1,228,11994,12930
28,95,11994,12089,1,119,11994,4739
28,95,11994,12089,-1,119,12089,12931
28,42,12089,12131,1,156,12089,4740
28,42,12089,12131,-1,156,12131,12932
28,176,12131,12307,1,185,12131,4741
28,176,12131,12307,-1,185,12307,12933
28,91,12307,12398,1,202,12307,4742
28,91,12307,12398,-1,202,12398,12934
28,141,12398,12539,1,166,12398,4743
28,141,12398,12539,-1,166,12539,12935
28,215,12539,12754,1,23,12539,4744
28,215,12539,12754,-1,23,12754,12936
28,107,12754,12861,1,85,12754,4745
28,107,12754,12861,-1,85,12861,12937
28,136,12861,12997,1,161,12861,4746
28,136,12861,12997,-1,161,12997,12938
28,59,12997,13056,1,2,12997,4747
28,59,12997,13056,-1,2,13056,12939
28,172,13056,13228,1,54,13056,4748
28,172,13056,13228,-1,54,13228,12940
28,213,13228,13441,1,47,13228,4749
28,213,13228,13441,-1,47,13441,12941
28,99,13441,13540,1,222,13441,4750
28,99,13441,13540,-1,222,13540,12942
28,89,13540,13629,1,87,13540,4751
28,89,13540,13629,-1,87,13629,12943
28,99,13629,13728,1,249,13629,4752
28,99,13629,13728,-1,249,13728,12944
28,96,13728,13824,1,2,13728,4753
28,96,13728,13824,-1,2,13824,12945
28,406,13824,14230,1,97,13824,4754
28,406,13824,14230,-1,97,14230,12946
28,347,14230,14577,1,148,14230,4755
28,347,14230,14577,-1,148,14577,12947
28,152,14577,14729,1,184,14577,4756
28,152,14577,14729,-1,184,14729,12948
28,102,14729,14831,1,128,14729,4757
28,102,14729,14831,-1,128,14831,12949
28,158,14831,14989,1,44,14831,4758
28,158,14831,14989,-1,44,14989,12950
28,58,14989,15047,1,13,14989,4759
28,58,14989,15047,-1,13,15047,12951
28,161,15047,15208,1,149,15047,4760
28,161,15047,15208,-1,149,15208,12952
28,68,15208,15276,1,121,15208,4761
28,68,15208,15276,-1,121,15276,12953
28,135,15276,15411,1,255,15276,4762
28,135,15276,15411,-1,255,15411,12954
28,99,15411,15510,1,130,15411,4763
28,99,15411,15510,-1,130,15510,12955
28,34,15510,15544,1,26,15510,4764
28,34,15510,15544,-1,26,15544,12956
28,229,15544,15773,1,93,15544,4765
28,229,15544,15773,-1,93,15773,12957
28,86,15773,15859,1,116,15773,4766
28,86,15773,15859,-1,116,15859,12958
28,256,15859,16115,1,228,15859,4767
28,256,15859,16115,-1,228,16115,12959
28,136,16115,16251,1,217,16115,4768
28,136,16115,16251,-1,217,16251,12960
28,111,16251,16362,1,38,16251,4769
28,111,16251,16362,-1,38,16362,12961
28,136,16362,16498,1,201,16362,4770
28,136,16362,16498,-1,201,16498,12962
28,73,16498,16571,1,64,16498,4771
28,73,16498,16571,-1,64,16571,12963
28,124,16571,16695,1,198,16571,4772
28,124,16571,16695,-1,198,16695,12964
28,120,16695,16815,1,20,16695,4773
28,120,16695,16815,-1,20,16815,12965
28,241,16815,17056,1,106,16815,4774
28,241,16815,17056,-1,106,17056,12966
28,135,17056,17191,1,235,17056,4775
28,135,17056,17191,-1,235,17191,12967
28,250,17191,17441,1,142,17191,4776
28,250,17191,17441,-1,142,17441,12968
28,66,17441,17507,1,102,17441,4777
28,66,17441,17507,-1,102,17507,12969
28,162,17507,17669,1,48,17507,4778
28,162,17507,17669,-1,48,17669,12970
28,212,17669,17881,1,155,17669,4779
28,212,17669,17881,-1,155,17881,12971
28,84,17881,17965,1,96,17881,4780
28,84,17881,17965,-1,96,17965,12972
28,220,17965,18185,1,90,17965,4781
28,220,17965,18185,-1,90,18185,12973
28,107,18185,18292,1,241,18185,4782
28,107,18185,18292,-1,241,18292,12974
28,160,18292,18452,1,216,18292,4783
28,160,18292,18452,-1,216,18452,12975
28,106,18452,18558,1,50,18452,4784
28,106,18452,18558,-1,50,18558,12976
28,102,18558,18660,1,48,18558,4785
28,102,18558,18660,-1,48,18660,12977
28,219,18660,18879,1,36,18660,4786
28,219,18660,18879,-1,36,18879,12978
28,112,18879,18991,1,239,18879,4787
28,112,18879,18991,-1,239,18991,12979
28,173,18991,19164,1,133,18991,4788
28,173,18991,19164,-1,133,19164,12980
28,211,19164,19375,1,190,19164,4789
28,211,19164,19375,-1,190,19375,12981
28,108,19375,19483,1,248,19375,4790
28,108,19375,19483,-1,248,19483,12982
28,61,19483,19544,1,173,19483,4791
28,61,19483,19544,-1,173,19544,12983
28,147,19544,19691,1,136,19544,4792
28,147,19544,19691,-1,136,19691,12984
28,102,19691,19793,1,55,19691,4793
28,102,19691,19793,-1,55,19793,12985
28,89,19793,19882,1,97,19793,4794
28,89,19793,19882,-1,97,19882,12986
28,83,19882,19965,1,91,19882,4795
28,83,19882,19965,-1,91,19965,12987
28,267,19965,20232,1,213,19965,4796
28,267,19965,20232,-1,213,20232,12988
28,110,20232,20342,1,208,20232,4797
28,110,20232,20342,-1,208,20342,12989
28,62,20342,20404,1,35,20342,4798
28,62,20342,20404,-1,35,20404,12990
28,80,20404,20484,1,253,20404,4799
28,80,20404,20484,-1,253,20484,12991
28,67,20484,20551,1,113,20484,4800
28,67,20484,20551,-1,113,20551,12992
28,81,20551,20632,1,128,20551,4801
28,81,20551,20632,-1,128,20632,12993
28,45,20632,20677,1,77,20632,4802
28,45,20632,20677,-1,77,20677,12994
28,167,20677,20844,1,96,20677,4803
28,167,20677,20844,-1,96,20844,12995
28,70,20844,20914,1,27,20844,4804
28,70,20844,20914,-1,27,20914,12996
28,95,20914,21009,1,126,20914,4805
28,95,20914,21009,-1,126,21009,12997
28,213,21009,21222,1,28,21009,4806
28,213,21009,21222,-1,28,21222,12998
28,209,21222,21431,1,245,21222,4807
28,209,21222,21431,-1,245,21431,12999
28,81,21431,21512,1,186,21431,4808
28,81,21431,21512,-1,186,21512,13000
28,99,21512,21611,1,183,21512,4809
28,99,21512,21611,-1,183,21611,13001
28,251,21611,21862,1,10,21611,4810
28,251,21611,21862,-1,10,21862,13002
28,145,21862,22007,1,147,21862,4811
28,145,21862,22007,-1,147,22007,13003
28,48,22007,22055,1,91,22007,4812
28,48,22007,22055,-1,91,22055,13004
28,97,22055,22152,1,57,22055,4813
28,97,22055,22152,-1,57,22152,13005
28,64,22152,22216,1,189,22152,4814
28,64,22152,22216,-1,189,22216,13006
28,156,22216,22372,1,235,22216,4815
28,156,22216,22372,-1,235,22372,13007
28,216,22372,22588,1,86,22372,4816
28,216,22372,22588,-1,86,22588,13008
28,119,22588,22707,1,233,22588,4817
28,119,22588,22707,-1,233,22707,13009
28,283,22707,22990,1,166,22707,4818
28,283,22707,22990,-1,166,22990,13010
28,21,22990,23011,1,154,22990,4819
28,21,22990,23011,-1,154,23011,13011
28,77,23011,23088,1,206,23011,4820
28,77,23011,23088,-1,206,23088,13012
28,151,23088,23239,1,217,23088,4821
28,151,23088,23239,-1,217,23239,13013
28,115,23239,23354,1,2,23239,4822
28,115,23239,23354,-1,2,23354,13014
28,80,23354,23434,1,148,23354,4823
28,80,23354,23434,-1,148,23434,13015
28,118,23434,23552,1,249,23434,4824
28,118,23434,23552,-1,249,23552,13016
28,50,23552,23602,1,60,23552,4825
28,50,23552,23602,-1,60,23602,13017
28,80,23602,23682,1,86,23602,4826
28,80,23602,23682,-1,86,23682,13018
28,134,23682,23816,1,132,23682,4827
28,134,23682,23816,-1,132,23816,13019
28,106,23816,23922,1,209,23816,4828
28,106,23816,23922,-1,209,23922,13020
28,122,23922,24044,1,226,23922,4829
28,122,23922,24044,-1,226,24044,13021
28,125,24044,24169,1,221,24044,4830
28,125,24044,24169,-1,221,24169,13022
28,134,24169,24303,1,89,24169,4831
28,134,24169,24303,-1,89,24303,13023
28,50,24303,24353,1,191,24303,4832
28,50,24303,24353,-1,191,24353,13024
28,161,24353,24514,1,60,24353,4833
28,161,24353,24514,-1,60,24514,13025
28,263,24514,24777,1,204,24514,4834
28,263,24514,24777,-1,204,24777,13026
28,169,24777,24946,1,195,24777,4835
28,169,24777,24946,-1,195,24946,13027
28,76,24946,25022,1,26,24946,4836
28,76,24946,25022,-1,26,25022,13028
28,47,25022,25069,1,121,25022,4837
28,47,25022,25069,-1,121,25069,13029
28,113,25069,25182,1,155,25069,4838
28,113,25069,25182,-1,155,25182,13030
28,191,25182,25373,1,97,25182,4839
28,191,25182,25373,-1,97,25373,13031
28,62,25373,25435,1,162,25373,4840
28,62,25373,25435,-1,162,25435,13032
28,50,25435,25485,1,108,25435,4841
28,50,25435,25485,-1,108,25485,13033
28,59,25485,25544,1,171,25485,4842
28,59,25485,25544,-1,171,25544,13034
28,82,25544,25626,1,97,25544,4843
28,82,25544,25626,-1,97,25626,13035
28,230,25626,25856,1,131,25626,4844
28,230,25626,25856,-1,131,25856,13036
28,340,25856,26196,1,9,25856,4845
28,340,25856,26196,-1,9,26196,13037
28,129,26196,26325,1,29,26196,4846
28,129,26196,26325,-1,29,26325,13038
28,155,26325,26480,1,103,26325,4847
28,155,26325,26480,-1,103,26480,13039
28,153,26480,26633,1,104,26480,4848
28,153,26480,26633,-1,104,26633,13040
28,57,26633,26690,1,102,26633,4849
28,57,26633,26690,-1,102,26690,13041
28,47,26690,26737,1,36,26690,4850
28,47,26690,26737,-1,36,26737,13042
28,103,26737,26840,1,255,26737,4851
28,103,26737,26840,-1,255,26840,13043
28,135,26840,26975,1,181,26840,4852
28,135,26840,26975,-1,181,26975,13044
28,108,26975,27083,1,33,26975,4853
28,108,26975,27083,-1,33,27083,13045
28,94,27083,27177,1,130,27083,4854
28,94,27083,27177,-1,130,27177,13046
28,169,27177,27346,1,250,27177,4855
28,169,27177,27346,-1,250,27346,13047
28,51,27346,27397,1,178,27346,4856
28,51,27346,27397,-1,178,27397,13048
28,65,27397,27462,1,84,27397,4857
28,65,27397,27462,-1,84,27462,13049
28,180,27462,27642,1,182,27462,4858
28,180,27462,27642,-1,182,27642,13050
28,222,27642,27864,1,251,27642,4859
28,222,27642,27864,-1,251,27864,13051
28,89,27864,27953,1,244,27864,4860
28,89,27864,27953,-1,244,27953,13052
28,123,27953,28076,1,52,27953,4861
28,123,27953,28076,-1,52,28076,13053
28,175,28076,28251,1,46,28076,4862
28,175,28076,28251,-1,46,28251,13054
28,244,28251,28495,1,214,28251,4863
28,244,28251,28495,-1,214,28495,13055
28,68,28495,28563,1,189,28495,4864
28,68,28495,28563,-1,189,28563,13056
28,74,28563,28637,1,135,28563,4865
28,74,28563,28637,-1,135,28637,13057
28,186,28637,28823,1,164,28637,4866
28,186,28637,28823,-1,164,28823,13058
28,205,28823,29028,1,135,28823,4867
28,205,28823,29028,-1,135,29028,13059
28,74,29028,29102,1,112,29028,4868
28,74,29028,29102,-1,112,29102,13060
28,44,29102,29146,1,226,29102,4869
28,44,29102,29146,-1,226,29146,13061
28,154,29146,29300,1,250,29146,4870
28,154,29146,29300,-1,250,29300,13062
28,128,29300,29428,1,254,29300,4871
28,128,29300,29428,-1,254,29428,13063
28,127,29428,29555,1,230,29428,4872
28,127,29428,29555,-1,230,29555,13064
28,109,29555,29664,1,182,29555,4873
28,109,29555,29664,-1,182,29664,13065
28,145,29664,29809,1,74,29664,4874
28,145,29664,29809,-1,74,29809,13066
28,165,29809,29974,1,245,29809,4875
28,165,29809,29974,-1,245,29974,13067
28,170,29974,30144,1,156,29974,4876
28,170,29974,30144,-1,156,30144,13068
28,47,30144,30191,1,148,30144,4877
28,47,30144,30191,-1,148,30191,13069
28,242,30191,30433,1,68,30191,4878
28,242,30191,30433,-1,68,30433,13070
28,168,30433,30601,1,212,30433,4879
28,168,30433,30601,-1,212,30601,13071
28,141,30601,30742,1,81,30601,4880
28,141,30601,30742,-1,81,30742,13072
28,90,30742,30832,1,114,30742,4881
28,90,30742,30832,-1,114,30832,13073
28,153,30832,30985,1,147,30832,4882
28,153,30832,30985,-1,147,30985,13074
28,189,30985,31174,1,157,30985,4883
28,189,30985,31174,-1,157,31174,13075
28,115,31174,31289,1,222,31174,4884
28,115,31174,31289,-1,222,31289,13076
28,101,31289,31390,1,131,31289,4885
28,101,31289,31390,-1,131,31390,13077
28,87,31390,31477,1,6,31390,4886
28,87,31390,31477,-1,6,31477,13078
28,19,31477,31496,1,123,31477,4887
28,19,31477,31496,-1,123,31496,13079
28,131,31496,31627,1,129,31496,4888
28,131,31496,31627,-1,129,31627,13080
28,81,31627,31708,1,114,31627,4889
28,81,31627,31708,-1,114,31708,13081
28,61,31708,31769,1,64,31708,4890
28,61,31708,31769,-1,64,31769,13082
28,181,31769,31950,1,15,31769,4891
28,181,31769,31950,-1,15,31950,13083
28,142,31950,32092,1,183,31950,4892
28,142,31950,32092,-1,183,32092,13084
28,187,32092,32279,1,155,32092,4893
28,187,32092,32279,-1,155,32279,13085
28,237,32279,32516,1,236,32279,4894
28,237,32279,32516,-1,236,32516,13086
28,69,32516,32585,1,88,32516,4895
28,69,32516,32585,-1,88,32585,13087
28,150,32585,32735,1,248,32585,4896
28,150,32585,32735,-1,248,32735,13088
28,43,32735,32778,1,155,32735,4897
28,43,32735,32778,-1,155,32778,13089
28,78,32778,32856,1,119,32778,4898
28,78,32778,32856,-1,119,32856,13090
28,103,32856,32959,1,146,32856,4899
28,103,32856,32959,-1,146,32959,13091
28,301,32959,33260,1,132,32959,4900
28,301,32959,33260,-1,132,33260,13092
28,76,33260,33336,1,11,33260,4901
28,76,33260,33336,-1,11,33336,13093
28,231,33336,33567,1,197,33336,4902
28,231,33336,33567,-1,197,33567,13094
28,233,33567,33800,1,95,33567,4903
28,233,33567,33800,-1,95,33800,13095
28,99,33800,33899,1,215,33800,4904
28,99,33800,33899,-1,215,33899,13096
28,148,33899,34047,1,60,33899,4905
28,148,33899,34047,-1,60,34047,13097
28,86,34047,34133,1,238,34047,4906
28,86,34047,34133,-1,238,34133,13098
28,159,34133,34292,1,97,34133,4907
28,159,34133,34292,-1,97,34292,13099
28,96,34292,34388,1,252,34292,4908
28,96,34292,34388,-1,252,34388,13100
28,178,34388,34566,1,147,34388,4909
28,178,34388,34566,-1,147,34566,13101
28,92,34566,34658,1,151,34566,4910
28,92,34566,34658,-1,151,34658,13102
28,129,34658,34787,1,131,34658,4911
28,129,34658,34787,-1,131,34787,13103
28,105,34787,34892,1,180,34787,4912
28,105,34787,34892,-1,180,34892,13104
28,137,34892,35029,1,11,34892,4913
28,137,34892,35029,-1,11,35029,13105
28,49,35029,35078,1,2,35029,4914
28,49,35029,35078,-1,2,35078,13106
29,116,0,116,1,249,0,7204
29,116,0,116,-1,249,116,15396
29,117,116,233,1,175,116,7205
29,117,116,233,-1,175,233,15397
29,61,233,294,1,77,233,7206
29,61,233,294,-1,77,294,15398
29,42,294,336,1,49,294,7207
29,42,294,336,-1,49,336,15399
29,117,336,453,1,7,336,7208
29,117,336,453,-1,7,453,15400
29,86,453,539,1,45,453,7209
29,86,453,539,-1,45,539,15401
29,216,539,755,1,159,539,7210
29,216,539,755,-1,159,755,15402
29,207,755,962,1,249,755,7211
29,207,755,962,-1,249,962,15403
29,145,962,1107,1,61,962,7212
29,145,962,1107,-1,61,1107,15404
29,259,1107,1366,1,211,1107,7213
29,259,1107,1366,-1,211,1366,15405
29,123,1366,1489,1,192,1366,7214
29,123,1366,1489,-1,192,1489,15406
29,66,1489,1555,1,29,1489,7215
29,66,1489,1555,-1,29,1555,15407
29,191,1555,1746,1,165,1555,7216
29,191,1555,1746,-1,165,1746,15408
29,239,1746,1985,1,23,1746,7217
29,239,1746,1985,-1,23,1985,15409
29,109,1985,2094,1,79,1985,7218
29,109,1985,2094,-1,79,2094,15410
29,144,2094,2238,1,84,2094,7219
29,144,2094,2238,-1,84,2238,15411
29,217,2238,2455,1,120,2238,7220
29,217,2238,2455,-1,120,2455,15412
29,170,2455,2625,1,218,2455,7221
29,170,2455,2625,-1,218,2625,15413
29,80,2625,2705,1,202,2625,7222
29,80,2625,2705,-1,202,2705,15414
29,107,2705,2812,1,31,2705,7223
29,107,2705,2812,-1,31,2812,15415
29,76,2812,2888,1,88,2812,7224
29,76,2812,2888,-1,88,2888,15416
29,119,2888,3007,1,49,2888,7225
29,119,2888,3007,-1,49,3007,15417
29,137,3007,3144,1,66,3007,7226
29,137,3007,3144,-1,66,3144,15418
29,112,3144,3256,1,200,3144,7227
29,112,3144,3256,-1,200,3256,15419
29,134,3256,3390,1,107,3256,7228
29,134,3256,3390,-1,107,3390,15420
29,71,3390,3461,1,196,3390,7229
29,71,3390,3461,-1,196,3461,15421
29,133,3461,3594,1,231,3461,7230
29,133,3461,3594,-1,231,3594,15422
29,76,3594,3670,1,95,3594,7231
29,76,3594,3670,-1,95,3670,15423
29,56,3670,3726,1,169,3670,7232
29,56,3670,3726,-1,169,3726,15424
29,90,3726,3816,1,47,3726,7233
29,90,3726,3816,-1,47,3816,15425
29,116,3816,3932,1,213,3816,7234
29,116,3816,3932,-1,213,3932,15426
29,263,3932,4195,1,251,3932,7235
29,263,3932,4195,-1,251,4195,15427
29,110,4195,4305,1,65,4195,7236
29,110,4195,4305,-1,65,4305,15428
29,187,4305,4492,1,159,4305,7237
29,187,4305,4492,-1,159,4492,15429
29,163,4492,4655,1,138,4492,7238
29,163,4492,4655,-1,138,4655,15430
29,84,4655,4739,1,162,4655,7239
29,84,4655,4739,-1,162,4739,15431
29,106,4739,4845,1,107,4739,7240
29,106,4739,4845,-1,107,4845,15432
29,104,4845,4949,1,91,4845,7241
29,104,4845,4949,-1,91,4949,15433
29,58,4949,5007,1,101,4949,7242
29,58,4949,5007,-1,101,5007,15434
29,73,5007,5080,1,81,5007,7243
29,73,5007,5080,-1,81,5080,15435
29,26,5080,5106,1,56,5080,7244
29,26,5080,5106,-1,56,5106,15436
29,175,5106,5281,1,8,5106,7245
29,175,5106,5281,-1,8,5281,15437
29,227,5281,5508,1,167,5281,7246
29,227,5281,5508,-1,167,5508,15438
29,187,5508,5695,1,30,5508,7247
29,187,5508,5695,-1,30,5695,15439
29,133,5695,5828,1,130,5695,7248
29,133,5695,5828,-1,130,5828,15440
29,126,5828,5954,1,56,5828,7249
29,126,5828,5954,-1,56,5954,15441
29,168,5954,6122,1,19,5954,7250
29,168,5954,6122,-1,19,6122,15442
29,44,6122,6166,1,139,6122,7251
29,44,6122,6166,-1,139,6166,15443
29,138,6166,6304,1,103,6166,7252
29,138,6166,6304,-1,103,6304,15444
29,42,6304,6346,1,99,6304,7253
29,42,6304,6346,-1,99,6346,15445
29,123,6346,6469,1,32,6346,7254
29,123,6346,6469,-1,32,6469,15446
29,115,6469,6584,1,141,6469,7255
29,115,6469,6584,-1,141,6584,15447
29,31,6584,6615,1,185,6584,7256
29,31,6584,6615,-1,185,6615,15448
29,72,6615,6687,1,202,6615,7257
29,72,6615,6687,-1,202,6687,15449
29,67,6687,6754,1,222,6687,7258
29,67,6687,6754,-1,222,6754,15450
29,78,6754,6832,1,45,6754,7259
29,78,6754,6832,-1,45,6832,15451
29,159,6832,6991,1,148,6832,7260
29,159,6832,6991,-1,148,6991,15452
29,61,6991,7052,1,188,6991,7261
29,61,6991,7052,-1,188,7052,15453
29,173,7052,7225,1,230,7052,7262
29,173,7052,7225,-1,230,7225,15454
29,105,7225,7330,1,100,7225,7263
29,105,7225,7330,-1,100,7330,15455
29,76,7330,7406,1,34,7330,7264
29,76,7330,7406,-1,34,7406,15456
29,61,7406,7467,1,112,7406,7265
29,61,7406,7467,-1,112,7467,15457
29,212,7467,7679,1,163,7467,7266
29,212,7467,7679,-1,163,7679,15458
29,101,7679,7780,1,121,7679,7267
29,101,7679,7780,-1,121,7780,15459
29,53,7780,7833,1,19,7780,7268
29,53,7780,7833,-1,19,7833,15460
29,140,7833,7973,1,33,7833,7269
29,140,7833,7973,-1,33,7973,15461
29,160,7973,8133,1,171,7973,7270
29,160,7973,8133,-1,171,8133,15462
29,108,8133,8241,1,116,8133,7271
29,108,8133,8241,-1,116,8241,15463
29,87,8241,8328,1,138,8241,7272
29,87,8241,8328,-1,138,8328,15464
29,336,8328,8664,1,234,8328,7273
29,336,8328,8664,-1,234,8664,15465
29,135,8664,8799,1,26,8664,7274
29,135,8664,8799,-1,26,8799,15466
29,180,8799,8979,1,134,8799,7275
29,180,8799,8979,-1,134,8979,15467
29,130,8979,9109,1,204,8979,7276
29,130,8979,9109,-1,204,9109,15468
29,129,9109,9238,1,2,9109,7277
29,129,9109,9238,-1,2,9238,15469
29,110,9238,9348,1,47,9238,7278
29,110,9238,9348,-1,47,9348,15470
29,77,9348,9425,1,1,9348,7279
29,77,9348,9425,-1,1,9425,15471
29,93,9425,9518,1,162,9425,7280
29,93,9425,9518,-1,162,9518,15472
29,60,9518,9578,1,89,9518,7281
29,60,9518,9578,-1,89,9578,15473
29,80,9578,9658,1,98,9578,7282
29,80,9578,9658,-1,98,9658,15474
29,92,9658,9750,1,235,9658,7283
29,92,9658,9750,-1,235,9750,15475
29,170,9750,9920,1,178,9750,7284
29,170,9750,9920,-1,178,9920,15476
29,89,9920,10009,1,56,9920,7285
29,89,9920,10009,-1,56,10009,15477
29,110,10009,10119,1,53,10009,7286
29,110,10009,10119,-1,53,10119,15478
29,124,10119,10243,1,49,10119,7287
29,124,10119,10243,-1,49,10243,15479
29,99,10243,10342,1,62,10243,7288
29,99,10243,10342,-1,62,10342,15480
29,303,10342,10645,1,225,10342,7289
29,303,10342,10645,-1,225,10645,15481
29,138,10645,10783,1,109,10645,7290
29,138,10645,10783,-1,109,10783,15482
29,87,10783,10870,1,16,10783,7291
29,87,10783,10870,-1,16,10870,15483
29,67,10870,10937,1,211,10870,7292
29,67,10870,10937,-1,211,10937,15484
29,138,10937,11075,1,118,10937,7293
29,138,10937,11075,-1,118,11075,15485
29,58,11075,11133,1,236,11075,7294
29,58,11075,11133,-1,236,11133,15486
29,130,11133,11263,1,170,11133,7295
29,130,11133,11263,-1,170,11263,15487
29,139,11263,11402,1,81,11263,7296
29,139,11263,11402,-1,81,11402,15488
29,38,11402,11440,1,65,11402,7297
29,38,11402,11440,-1,65,11440,15489
29,114,11440,11554,1,125,11440,7298
29,114,11440,11554,-1,125,11554,15490
29,70,11554,11624,1,134,11554,7299
29,70,11554,11624,-1,134,11624,15491
29,183,11624,11807,1,117,11624,7300
29,183,11624,11807,-1,117,11807,15492
29,105,11807,11912,1,12,11807,7301
29,105,11807,11912,-1,12,11912,15493
29,68,11912,11980,1,84,11912,7302
29,68,11912,11980,-1,84,11980,15494
29,213,11980,12193,1,84,11980,7303
29,213,11980,12193,-1,84,12193,15495
29,138,12193,12331,1,227,12193,7304
29,138,12193,12331,-1,227,12331,15496
29,101,12331,12432,1,126,12331,7305
29,101,12331,12432,-1,126,12432,15497
29,216,12432,12648,1,37,12432,7306
29,216,12432,12648,-1,37,12648,15498
29,76,12648,12724,1,40,12648,7307
29,76,12648,12724,-1,40,12724,15499
29,86,12724,12810,1,45,12724,7308
29,86,12724,12810,-1,45,12810,15500
29,135,12810,12945,1,151,12810,7309
29,135,12810,12945,-1,151,12945,15501
29,86,12945,13031,1,128,12945,7310
29,86,12945,13031,-1,128,13031,15502
29,64,13031,13095,1,12,13031,7311
29,64,13031,13095,-1,12,13095,15503
29,322,13095,13417,1,58,13095,7312
29,322,13095,13417,-1,58,13417,15504
29,197,13417,13614,1,49,13417,7313
29,197,13417,13614,-1,49,13614,15505
29,316,13614,13930,1,40,13614,7314
29,316,13614,13930,-1,40,13930,15506
29,103,13930,14033,1,254,13930,7315
29,103,13930,14033,-1,254,14033,15507
29,77,14033,14110,1,186,14033,7316
29,77,14033,14110,-1,186,14110,15508
29,280,14110,14390,1,155,14110,7317
29,280,14110,14390,-1,155,14390,15509
29,242,14390,14632,1,85,14390,7318
29,242,14390,14632,-1,85,14632,15510
29,154,14632,14786,1,27,14632,7319
29,154,14632,14786,-1,27,14786,15511
29,73,14786,14859,1,195,14786,7320
29,73,14786,14859,-1,195,14859,15512
29,161,14859,15020,1,121,14859,7321
29,161,14859,15020,-1,121,15020,15513
29,107,15020,15127,1,178,15020,7322
29,107,15020,15127,-1,178,15127,15514
29,143,15127,15270,1,161,15127,7323
29,143,15127,15270,-1,161,15270,15515
29,162,15270,15432,1,177,15270,7324
29,162,15270,15432,-1,177,15432,15516
29,120,15432,15552,1,173,15432,7325
29,120,15432,15552,-1,173,15552,15517
29,145,15552,15697,1,80,15552,7326
29,145,15552,15697,-1,80,15697,15518
29,69,15697,15766,1,106,15697,7327
29,69,15697,15766,-1,106,15766,15519
29,82,15766,15848,1,128,15766,7328
29,82,15766,15848,-1,128,15848,15520
29,67,15848,15915,1,213,15848,7329
29,67,15848,15915,-1,213,15915,15521
29,91,15915,16006,1,71,15915,7330
29,91,15915,16006,-1,71,16006,15522
29,210,16006,16216,1,15,16006,7331
29,210,16006,16216,-1,15,16216,15523
29,106,16216,16322,1,5,16216,7332
29,106,16216,16322,-1,5,16322,15524
29,125,16322,16447,1,187,16322,7333
29,125,16322,16447,-1,187,16447,15525
29,86,16447,16533,1,196,16447,7334
29,86,16447,16533,-1,196,16533,15526
29,69,16533,16602,1,172,16533,7335
29,69,16533,16602,-1,172,16602,15527
29,212,16602,16814,1,120,16602,7336
29,212,16602,16814,-1,120,16814,15528
29,48,16814,16862,1,101,16814,7337
29,48,16814,16862,-1,101,16862,15529
29,118,16862,16980,1,75,16862,7338
29,118,16862,16980,-1,75,16980,15530
29,246,16980,17226,1,137,16980,7339
29,246,16980,17226,-1,137,17226,15531
29,79,17226,17305,1,203,17226,7340
29,79,17226,17305,-1,203,17305,15532
29,231,17305,17536,1,45,17305,7341
29,231,17305,17536,-1,45,17536,15533
29,204,17536,17740,1,68,17536,7342
29,204,17536,17740,-1,68,17740,15534
29,113,17740,17853,1,27,17740,7343
29,113,17740,17853,-1,27,17853,15535
29,31,17853,17884,1,15,17853,7344
29,31,17853,17884,-1,15,17884,15536
29,43,17884,17927,1,202,17884,7345
29,43,17884,17927,-1,202,17927,15537
29,183,17927,18110,1,99,17927,7346
29,183,17927,18110,-1,99,18110,15538
29,97,18110,18207,1,241,18110,7347
29,97,18110,18207,-1,241,18207,15539
29,63,18207,18270,1,105,18207,7348
29,63,18207,18270,-1,105,18270,15540
29,407,18270,18677,1,235,18270,7349
29,407,18270,18677,-1,235,18677,15541
29,218,18677,18895,1,62,18677,7350
29,218,18677,18895,-1,62,18895,15542
29,162,18895,19057,1,8,18895,7351
29,162,18895,19057,-1,8,19057,15543
29,185,19057,19242,1,108,19057,7352
29,185,19057,19242,-1,108,19242,15544
29,157,19242,19399,1,76,19242,7353
29,157,19242,19399,-1,76,19399,15545
29,189,19399,19588,1,238,19399,7354
29,189,19399,19588,-1,238,19588,15546
29,132,19588,19720,1,68,19588,7355
29,132,19588,19720,-1,68,19720,15547
29,127,19720,19847,1,212,19720,7356
29,127,19720,19847,-1,212,19847,15548
29,141,19847,19988,1,209,19847,7357
29,141,19847,19988,-1,209,19988,15549
29,144,19988,20132,1,212,19988,7358
29,144,19988,20132,-1,212,20132,15550
29,262,20132,20394,1,244,20132,7359
29,262,20132,20394,-1,244,20394,15551
29,51,20394,20445,1,180,20394,7360
29,51,20394,20445,-1,180,20445,15552
29,104,20445,20549,1,108,20445,7361
29,104,20445,20549,-1,108,20549,15553
29,106,20549,20655,1,93,20549,7362
29,106,20549,20655,-1,93,20655,15554
29,78,20655,20733,1,133,20655,7363
29,78,20655,20733,-1,133,20733,15555
29,59,20733,20792,1,49,20733,7364
29,59,20733,20792,-1,49,20792,15556
29,106,20792,20898,1,156,20792,7365
29,106,20792,20898,-1,156,20898,15557
29,155,20898,21053,1,11,20898,7366
29,155,20898,21053,-1,11,21053,15558
29,85,21053,21138,1,79,21053,7367
29,85,21053,21138,-1,79,21138,15559
29,137,21138,21275,1,121,21138,7368
29,137,21138,21275,-1,121,21275,15560
29,73,21275,21348,1,157,21275,7369
29,73,21275,21348,-1,157,21348,15561
29,92,21348,21440,1,163,21348,7370
29,92,21348,21440,-1,163,21440,15562
29,71,21440,21511,1,146,21440,7371
29,71,21440,21511,-1,146,21511,15563
29,66,21511,21577,1,159,21511,7372
29,66,21511,21577,-1,159,21577,15564
29,78,21577,21655,1,78,21577,7373
29,78,21577,21655,-1,78,21655,15565
29,62,21655,21717,1,245,21655,7374
29,62,21655,21717,-1,245,21717,15566
29,106,21717,21823,1,172,21717,7375
29,106,21717,21823,-1,172,21823,15567
29,243,21823,22066,1,113,21823,7376
29,243,21823,22066,-1,113,22066,15568
29,96,22066,22162,1,116,22066,7377
29,96,22066,22162,-1,116,22162,15569
29,195,22162,22357,1,73,22162,7378
29,195,22162,22357,-1,73,22357,15570
29,71,22357,22428,1,180,22357,7379
29,71,22357,22428,-1,180,22428,15571
29,56,22428,22484,1,244,22428,7380
29,56,22428,22484,-1,244,22484,15572
29,156,22484,22640,1,33,22484,7381
29,156,22484,22640,-1,33,22640,15573
29,57,22640,22697,1,176,22640,7382
29,57,22640,22697,-1,176,22697,15574
29,111,22697,22808,1,217,22697,7383
29,111,22697,22808,-1,217,22808,15575
29,223,22808,23031,1,89,22808,7384
29,223,22808,23031,-1,89,23031,15576
29,67,23031,23098,1,68,23031,7385
29,67,23031,23098,-1,68,23098,15577
29,112,23098,23210,1,111,23098,7386
29,112,23098,23210,-1,111,23210,15578
29,309,23210,23519,1,109,23210,7387
29,309,23210,23519,-1,109,23519,15579
29,60,23519,23579,1,185,23519,7388
29,60,23519,23579,-1,185,23579,15580
29,55,23579,23634,1,152,23579,7389
29,55,23579,23634,-1,152,23634,15581
29,143,23634,23777,1,50,23634,7390
29,143,23634,23777,-1,50,23777,15582
29,155,23777,23932,1,63,23777,7391
29,155,23777,23932,-1,63,23932,15583
29,191,23932,24123,1,218,23932,7392
29,191,23932,24123,-1,218,24123,15584
29,192,24123,24315,1,143,24123,7393
29,192,24123,24315,-1,143,24315,15585
29,43,24315,24358,1,140,24315,7394
29,43,24315,24358,-1,140,24358,15586
29,92,24358,24450,1,214,24358,7395
29,92,24358,24450,-1,214,24450,15587
29,134,24450,24584,1,251,24450,7396
29,134,24450,24584,-1,251,24584,15588
29,268,24584,24852,1,255,24584,7397
29,268,24584,24852,-1,255,24852,15589
29,80,24852,24932,1,65,24852,7398
29,80,24852,24932,-1,65,24932,15590
29,75,24932,25007,1,227,24932,7399
29,75,24932,25007,-1,227,25007,15591
29,77,25007,25084,1,210,25007,7400
29,77,25007,25084,-1,210,25084,15592
29,139,25084,25223,1,214,25084,7401
29,139,25084,25223,-1,214,25223,15593
29,78,25223,25301,1,203,25223,7402
29,78,25223,25301,-1,203,25301,15594
29,38,25301,25339,1,90,25301,7403
29,38,25301,25339,-1,90,25339,15595
29,195,25339,25534,1,251,25339,7404
29,195,25339,25534,-1,251,25534,15596
29,68,25534,25602,1,6,25534,7405
29,68,25534,25602,-1,6,25602,15597
29,70,25602,25672,1,211,25602,7406
29,70,25602,25672,-1,211,25672,15598
29,97,25672,25769,1,127,25672,7407
29,97,25672,25769,-1,127,25769,15599
29,129,25769,25898,1,157,25769,7408
29,129,25769,25898,-1,157,25898,15600
29,106,25898,26004,1,43,25898,7409
29,106,25898,26004,-1,43,26004,15601
29,84,26004,26088,1,32,26004,7410
29,84,26004,26088,-1,32,26088,15602
29,115,26088,26203,1,50,26088,7411
29,115,26088,26203,-1,50,26203,15603
29,117,26203,26320,1,105,26203,7412
29,117,26203,26320,-1,105,26320,15604
29,155,26320,26475,1,203,26320,7413
29,155,26320,26475,-1,203,26475,15605
29,92,26475,26567,1,130,26475,7414
29,92,26475,26567,-1,130,26567,15606
29,200,26567,26767,1,90,26567,7415
29,200,26567,26767,-1,90,26767,15607
29,157,26767,26924,1,116,26767,7416
29,157,26767,26924,-1,116,26924,15608
29,165,26924,27089,1,203,26924,7417
29,165,26924,27089,-1,203,27089,15609
29,63,27089,27152,1,151,27089,7418
29,63,27089,27152,-1,151,27152,15610
29,252,27152,27404,1,68,27152,7419
29,252,27152,27404,-1,68,27404,15611
29,130,27404,27534,1,14,27404,7420
29,130,27404,27534,-1,14,27534,15612
29,45,27534,27579,1,44,27534,7421
29,45,27534,27579,-1,44,27579,15613
29,201,27579,27780,1,227,27579,7422
29,201,27579,27780,-1,227,27780,15614
29,105,27780,27885,1,1,27780,7423
29,105,27780,27885,-1,1,27885,15615
29,111,27885,27996,1,109,27885,7424
29,111,27885,27996,-1,109,27996,15616
29,73,27996,28069,1,136,27996,7425
29,73,27996,28069,-1,136,28069,15617
29,199,28069,28268,1,193,28069,7426
29,199,28069,28268,-1,193,28268,15618
29,177,28268,28445,1,119,28268,7427
29,177,28268,28445,-1,119,28445,15619
29,90,28445,28535,1,149,28445,7428
29,90,28445,28535,-1,149,28535,15620
29,125,28535,28660,1,48,28535,7429
29,125,28535,28660,-1,48,28660,15621
29,205,28660,28865,1,137,28660,7430
29,205,28660,28865,-1,137,28865,15622
29,212,28865,29077,1,105,28865,7431
29,212,28865,29077,-1,105,29077,15623
29,165,29077,29242,1,34,29077,7432
29,165,29077,29242,-1,34,29242,15624
29,149,29242,29391,1,99,29242,7433
29,149,29242,29391,-1,99,29391,15625
29,98,29391,29489,1,122,29391,7434
29,98,29391,29489,-1,122,29489,15626
29,129,29489,29618,1,207,29489,7435
29,129,29489,29618,-1,207,29618,15627
29,76,29618,29694,1,226,29618,7436
29,76,29618,29694,-1,226,29694,15628
29,144,29694,29838,1,144,29694,7437
29,144,29694,29838,-1,144,29838,15629
29,123,29838,29961,1,208,29838,7438
29,123,29838,29961,-1,208,29961,15630
29,65,29961,30026,1,219,29961,7439
29,65,29961,30026,-1,219,30026,15631
29,73,30026,30099,1,60,30026,7440
29,73,30026,30099,-1,60,30099,15632
29,105,30099,30204,1,114,30099,7441
29,105,30099,30204,-1,114,30204,15633
29,141,30204,30345,1,177,30204,7442
29,141,30204,30345,-1,177,30345,15634
29,162,30345,30507,1,63,30345,7443
29,162,30345,30507,-1,63,30507,15635
29,98,30507,30605,1,122,30507,7444
29,98,30507,30605,-1,122,30605,15636
29,109,30605,30714,1,62,30605,7445
29,109,30605,30714,-1,62,30714,15637
29,233,30714,30947,1,76,30714,7446
29,233,30714,30947,-1,76,30947,15638
29,97,30947,31044,1,70,30947,7447
29,97,30947,31044,-1,70,31044,15639
29,44,31044,31088,1,102,31044,7448
29,44,31044,31088,-1,102,31088,15640
29,198,31088,31286,1,44,31088,7449
29,198,31088,31286,-1,44,31286,15641
29,112,31286,31398,1,217,31286,7450
29,112,31286,31398,-1,217,31398,15642
29,141,31398,31539,1,104,31398,7451
29,141,31398,31539,-1,104,31539,15643
29,147,31539,31686,1,121,31539,7452
29,147,31539,31686,-1,121,31686,15644
29,144,31686,31830,1,238,31686,7453
29,144,31686,31830,-1,238,31830,15645
29,116,31830,31946,1,156,31830,7454
29,116,31830,31946,-1,156,31946,15646
29,52,31946,31998,1,130,31946,7455
29,52,31946,31998,-1,130,31998,15647
29,100,31998,32098,1,18,31998,7456
29,100,31998,32098,-1,18,32098,15648
29,242,32098,32340,1,46,32098,7457
29,242,32098,32340,-1,46,32340,15649
29,53,32340,32393,1,222,32340,7458
29,53,32340,32393,-1,222,32393,15650
29,112,32393,32505,1,63,32393,7459
29,112,32393,32505,-1,63,32505,15651
29,165,32505,32670,1,54,32505,7460
29,165,32505,32670,-1,54,32670,15652
29,184,32670,32854,1,31,32670,7461
29,184,32670,32854,-1,31,32854,15653
29,322,32854,33176,1,233,32854,7462
29,322,32854,33176,-1,233,33176,15654
29,62,33176,33238,1,45,33176,7463
29,62,33176,33238,-1,45,33238,15655
29,164,33238,33402,1,13,33238,7464
29,164,33238,33402,-1,13,33402,15656
29,164,33402,33566,1,220,33402,7465
29,164,33402,33566,-1,220,33566,15657
29,232,33566,33798,1,58,33566,7466
29,232,33566,33798,-1,58,33798,15658
29,127,33798,33925,1,4,33798,7467
29,127,33798,33925,-1,4,33925,15659
29,46,33925,33971,1,55,33925,7468
29,46,33925,33971,-1,55,33971,15660
29,233,33971,34204,1,113,33971,7469
29,233,33971,34204,-1,113,34204,15661
29,116,34204,34320,1,169,34204,7470
29,116,34204,34320,-1,169,34320,15662
29,174,34320,34494,1,51,34320,7471
29,174,34320,34494,-1,51,34494,15663
29,148,34494,34642,1,163,34494,7472
29,148,34494,34642,-1,163,34642,15664
30,227,0,227,1,2,0,270
30,227,0,227,-1,2,227,8462
30,169,227,396,1,26,227,271
30,169,227,396,-1,26,396,8463
30,121,396,517,1,66,396,272
30,121,396,517,-1,66,517,8464
30,210,517,727,1,49,517,273
30,210,517,727,-1,49,727,8465
30,103,727,830,1,52,727,274
30,103,727,830,-1,52,830,8466
30,56,830,886,1,40,830,275
30,56,830,886,-1,40,886,8467
30,295,886,1181,1,252,886,276
30,295,886,1181,-1,252,1181,8468
30,141,1181,1322,1,68,1181,277
30,141,1181,1322,-1,68,1322,8469
30,341,1322,1663,1,100,1322,278
30,341,1322,1663,-1,100,1663,8470
30,116,1663,1779,1,99,1663,279
30,116,1663,1779,-1,99,1779,8471
30,51,1779,1830,1,252,1779,280
30,51,1779,1830,-1,252,1830,8472
30,119,1830,1949,1,15,1830,281
30,119,1830,1949,-1,15,1949,8473
30,160,1949,2109,1,34,1949,282
30,160,1949,2109,-1,34,2109,8474
30,108,2109,2217,1,182,2109,283
30,108,2109,2217,-1,182,2217,8475
30,134,2217,2351,1,136,2217,284
30,134,2217,2351,-1,136,2351,8476
30,84,2351,2435,1,166,2351,285
30,84,2351,2435,-1,166,2435,8477
30,62,2435,2497,1,193,2435,286
30,62,2435,2497,-1,193,2497,8478
30,56,2497,2553,1,136,2497,287
30,56,2497,2553,-1,136,2553,8479
30,100,2553,2653,1,139,2553,288
30,100,2553,2653,-1,139,2653,8480
30,287,2653,2940,1,116,2653,289
30,287,2653,2940,-1,116,2940,8481
30,199,2940,3139,1,185,2940,290
30,199,2940,3139,-1,185,3139,8482
30,91,3139,3230,1,184,3139,291
30,91,3139,3230,-1,184,3230,8483
30,172,3230,3402,1,178,3230,292
30,172,3230,3402,-1,178,3402,8484
30,87,3402,3489,1,177,3402,293
30,87,3402,3489,-1,177,3489,8485
30,196,3489,3685,1,7,3489,294
30,196,3489,3685,-1,7,3685,8486
30,115,3685,3800,1,160,3685,295
30,115,3685,3800,-1,160,3800,8487
30,189,3800,3989,1,45,3800,296
30,189,3800,3989,-1,45,3989,8488
30,128,3989,4117,1,129,3989,297
30,128,3989,4117,-1,129,4117,8489
30,232,4117,4349,1,78,4117,298
30,232,4117,4349,-1,78,4349,8490
30,61,4349,4410,1,1,4349,299
30,61,4349,4410,-1,1,4410,8491
30,93,4410,4503,1,139,4410,300
30,93,4410,4503,-1,139,4503,8492
30,186,4503,4689,1,87,4503,301
30,186,4503,4689,-1,87,4689,8493
30,270,4689,4959,1,118,4689,302
30,270,4689,4959,-1,118,4959,8494
30,110,4959,5069,1,190,4959,303
30,110,4959,5069,-1,190,5069,8495
30,234,5069,5303,1,155,5069,304
30,234,5069,5303,-1,155,5303,8496
30,13,5303,5316,1,206,5303,305
30,13,5303,5316,-1,206,5316,8497
30,38,5316,5354,1,82,5316,306
30,38,5316,5354,-1,82,5354,8498
30,130,5354,5484,1,15,5354,307
30,130,5354,5484,-1,15,5484,8499
30,64,5484,5548,1,237,5484,308
30,64,5484,5548,-1,237,5548,8500
30,75,5548,5623,1,36,5548,309
30,75,5548,5623,-1,36,5623,8501
30,313,5623,5936,1,88,5623,310
30,313,5623,5936,-1,88,5936,8502
30,247,5936,6183,1,37,5936,311
30,247,5936,6183,-1,37,6183,8503
30,139,6183,6322,1,11,6183,312
30,139,6183,6322,-1,11,6322,8504
30,91,6322,6413,1,36,6322,313
30,91,6322,6413,-1,36,6413,8505
30,166,6413,6579,1,33,6413,314
30,166,6413,6579,-1,33,6579,8506
30,33,6579,6612,1,83,6579,315
30,33,6579,6612,-1,83,6612,8507
30,196,6612,6808,1,252,6612,316
30,196,6612,6808,-1,252,6808,8508
30,115,6808,6923,1,180,6808,317
30,115,6808,6923,-1,180,6923,8509
30,132,6923,7055,1,118,6923,318
30,132,6923,7055,-1,118,7055,8510
30,76,7055,7131,1,23,7055,319
30,76,7055,7131,-1,23,7131,8511
30,67,7131,7198,1,9,7131,320
30,67,7131,7198,-1,9,7198,8512
30,112,7198,7310,1,17,7198,321
30,112,7198,7310,-1,17,7310,8513
30,38,7310,7348,1,185,7310,322
30,38,7310,7348,-1,185,7348,8514
30,32,7348,7380,1,46,7348,323
30,32,7348,7380,-1,46,7380,8515
30,185,7380,7565,1,195,7380,324
30,185,7380,7565,-1,195,7565,8516
30,198,7565,7763,1,18,7565,325
30,198,7565,7763,-1,18,7763,8517
30,163,7763,7926,1,213,7763,326
30,163,7763,7926,-1,213,7926,8518
30,62,7926,7988,1,68,7926,327
30,62,7926,7988,-1,68,7988,8519
30,163,7988,8151,1,68,7988,328
30,163,7988,8151,-1,68,8151,8520
30,171,8151,8322,1,208,8151,329
30,171,8151,8322,-1,208,8322,8521
30,256,8322,8578,1,125,8322,330
30,256,8322,8578,-1,125,8578,8522
30,233,8578,8811,1,6,8578,331
30,233,8578,8811,-1,6,8811,8523
30,37,8811,8848,1,157,8811,332
30,37,8811,8848,-1,157,8848,8524
30,61,8848,8909,1,7,8848,333
30,61,8848,8909,-1,7,8909,8525
30,57,8909,8966,1,14,8909,334
30,57,8909,8966,-1,14,8966,8526
30,161,8966,9127,1,135,8966,335
30,161,8966,9127,-1,135,9127,8527
30,87,9127,9214,1,244,9127,336
30,87,9127,9214,-1,244,9214,8528
30,157,9214,9371,1,119,9214,337
30,157,9214,9371,-1,119,9371,8529
30,172,9371,9543,1,198,9371,338
30,172,9371,9543,-1,198,9543,8530
30,87,9543,9630,1,77,9543,339
30,87,9543,9630,-1,77,9630,8531
30,39,9630,9669,1,112,9630,340
30,39,9630,9669,-1,112,9669,8532
30,101,9669,9770,1,24,9669,341
30,101,9669,9770,-1,24,9770,8533
30,88,9770,9858,1,179,9770,342
30,88,9770,9858,-1,179,9858,8534
30,151,9858,10009,1,104,9858,343
30,151,9858,10009,-1,104,10009,8535
30,72,10009,10081,1,2,10009,344
30,72,10009,10081,-1,2,10081,8536
30,152,10081,10233,1,216,10081,345
30,152,10081,10233,-1,216,10233,8537
30,198,10233,10431,1,218,10233,346
30,198,10233,10431,-1,218,10431,8538
30,61,10431,10492,1,58,10431,347
30,61,10431,10492,-1,58,10492,8539
30,264,10492,10756,1,177,10492,348
30,264,10492,10756,-1,177,10756,8540
30,224,10756,10980,1,234,10756,349
30,224,10756,10980,-1,234,10980,8541
30,103,10980,11083,1,250,10980,350
30,103,10980,11083,-1,250,11083,8542
30,103,11083,11186,1,182,11083,351
30,103,11083,11186,-1,182,11186,8543
30,87,11186,11273,1,197,11186,352
30,87,11186,11273,-1,197,11273,8544
30,107,11273,11380,1,236,11273,353
30,107,11273,11380,-1,236,11380,8545
30,105,11380,11485,1,90,11380,354
30,105,11380,11485,-1,90,11485,8546
30,173,11485,11658,1,87,11485,355
30,173,11485,11658,-1,87,11658,8547
30,104,11658,11762,1,22,11658,356
30,104,11658,11762,-1,22,11762,8548
30,94,11762,11856,1,170,11762,357
30,94,11762,11856,-1,170,11856,8549
30,140,11856,11996,1,199,11856,358
30,140,11856,11996,-1,199,11996,8550
30,78,11996,12074,1,142,11996,359
30,78,11996,12074,-1,142,12074,8551
30,81,12074,12155,1,146,12074,360
30,81,12074,12155,-1,146,12155,8552
30,172,12155,12327,1,69,12155,361
30,172,12155,12327,-1,69,12327,8553
30,49,12327,12376,1,82,12327,362
30,49,12327,12376,-1,82,12376,8554
30,95,12376,12471,1,23,12376,363
30,95,12376,12471,-1,23,12471,8555
30,132,12471,12603,1,80,12471,364
30,132,12471,12603,-1,80,12603,8556
30,68,12603,12671,1,238,12603,365
30,68,12603,12671,-1,238,12671,8557
30,27,12671,12698,1,231,12671,366
30,27,12671,12698,-1,231,12698,8558
30,34,12698,12732,1,157,12698,367
30,34,12698,12732,-1,157,12732,8559
30,130,12732,12862,1,214,12732,368
30,130,12732,12862,-1,214,12862,8560
30,92,12862,12954,1,230,12862,369
30,92,12862,12954,-1,230,12954,8561
30,77,12954,13031,1,73,12954,370
30,77,12954,13031,-1,73,13031,8562
30,98,13031,13129,1,81,13031,371
30,98,13031,13129,-1,81,13129,8563
30,63,13129,13192,1,52,13129,372
30,63,13129,13192,-1,52,13192,8564
30,62,13192,13254,1,221,13192,373
30,62,13192,13254,-1,221,13254,8565
30,134,13254,13388,1,52,13254,374
30,134,13254,13388,-1,52,13388,8566
30,178,13388,13566,1,224,13388,375
30,178,13388,13566,-1,224,13566,8567
30,74,13566,13640,1,80,13566,376
30,74,13566,13640,-1,80,13640,8568
30,96,13640,13736,1,10,13640,377
30,96,13640,13736,-1,10,13736,8569
30,36,13736,13772,1,195,13736,378
30,36,13736,13772,-1,195,13772,8570
30,73,13772,13845,1,236,13772,379
30,73,13772,13845,-1,236,13845,8571
30,108,13845,13953,1,118,13845,380
30,108,13845,13953,-1,118,13953,8572
30,97,13953,14050,1,101,13953,381
30,97,13953,14050,-1,101,14050,8573
30,68,14050,14118,1,64,14050,382
30,68,14050,14118,-1,64,14118,8574
30,53,14118,14171,1,235,14118,383
30,53,14118,14171,-1,235,14171,8575
30,123,14171,14294,1,7,14171,384
30,123,14171,14294,-1,7,14294,8576
30,165,14294,14459,1,121,14294,385
30,165,14294,14459,-1,121,14459,8577
30,186,14459,14645,1,91,14459,386
30,186,14459,14645,-1,91,14645,8578
30,15,14645,14660,1,97,14645,387
30,15,14645,14660,-1,97,14660,8579
30,205,14660,14865,1,150,14660,388
30,205,14660,14865,-1,150,14865,8580
30,110,14865,14975,1,53,14865,389
30,110,14865,14975,-1,53,14975,8581
30,138,14975,15113,1,17,14975,390
30,138,14975,15113,-1,17,15113,8582
30,147,15113,15260,1,73,15113,391
30,147,15113,15260,-1,73,15260,8583
30,219,15260,15479,1,256,15260,392
30,219,15260,15479,-1,256,15479,8584
30,56,15479,15535,1,62,15479,393
30,56,15479,15535,-1,62,15535,8585
30,227,15535,15762,1,144,15535,394
30,227,15535,15762,-1,144,15762,8586
30,116,15762,15878,1,214,15762,395
30,116,15762,15878,-1,214,15878,8587
30,109,15878,15987,1,225,15878,396
30,109,15878,15987,-1,225,15987,8588
30,175,15987,16162,1,203,15987,397
30,175,15987,16162,-1,203,16162,8589
30,51,16162,16213,1,113,16162,398
30,51,16162,16213,-1,113,16213,8590
30,34,16213,16247,1,152,16213,399
30,34,16213,16247,-1,152,16247,8591
30,128,16247,16375,1,76,16247,400
30,128,16247,16375,-1,76,16375,8592
30,160,16375,16535,1,22,16375,401
30,160,16375,16535,-1,22,16535,8593
30,228,16535,16763,1,86,16535,402
30,228,16535,16763,-1,86,16763,8594
30,192,16763,16955,1,41,16763,403
30,192,16763,16955,-1,41,16955,8595
30,88,16955,17043,1,235,16955,404
30,88,16955,17043,-1,235,17043,8596
30,141,17043,17184,1,207,17043,405
30,141,17043,17184,-1,207,17184,8597
30,74,17184,17258,1,206,17184,406
30,74,17184,17258,-1,206,17258,8598
30,174,17258,17432,1,125,17258,407
30,174,17258,17432,-1,125,17432,8599
30,271,17432,17703,1,157,17432,408
30,271,17432,17703,-1,157,17703,8600
30,76,17703,17779,1,15,17703,409
30,76,17703,17779,-1,15,17779,8601
30,111,17779,17890,1,125,17779,410
30,111,17779,17890,-1,125,17890,8602
30,183,17890,18073,1,199,17890,411
30,183,17890,18073,-1,199,18073,8603
30,51,18073,18124,1,120,18073,412
30,51,18073,18124,-1,120,18124,8604
30,61,18124,18185,1,212,18124,413
30,61,18124,18185,-1,212,18185,8605
30,219,18185,18404,1,240,18185,414
30,219,18185,18404,-1,240,18404,8606
30,185,18404,18589,1,244,18404,415
30,185,18404,18589,-1,244,18589,8607
30,133,18589,18722,1,168,18589,416
30,133,18589,18722,-1,168,18722,8608
30,71,18722,18793,1,106,18722,417
30,71,18722,18793,-1,106,18793,8609
30,41,18793,18834,1,53,18793,418
30,41,18793,18834,-1,53,18834,8610
30,150,18834,18984,1,233,18834,419
30,150,18834,18984,-1,233,18984,8611
30,155,18984,19139,1,126,18984,420
30,155,18984,19139,-1,126,19139,8612
30,76,19139,19215,1,119,19139,421
30,76,19139,19215,-1,119,19215,8613
30,106,19215,19321,1,78,19215,422
30,106,19215,19321,-1,78,19321,8614
30,142,19321,19463,1,112,19321,423
30,142,19321,19463,-1,112,19463,8615
30,81,19463,19544,1,176,19463,424
30,81,19463,19544,-1,176,19544,8616
30,72,19544,19616,1,12,19544,425
30,72,19544,19616,-1,12,19616,8617
30,151,19616,19767,1,32,19616,426
30,151,19616,19767,-1,32,19767,8618
30,128,19767,19895,1,193,19767,427
30,128,19767,19895,-1,193,19895,8619
30,211,19895,20106,1,87,19895,428
30,211,19895,20106,-1,87,20106,8620
30,71,20106,20177,1,213,20106,429
30,71,20106,20177,-1,213,20177,8621
30,125,20177,20302,1,26,20177,430
30,125,20177,20302,-1,26,20302,8622
30,108,20302,20410,1,25,20302,431
30,108,20302,20410,-1,25,20410,8623
30,79,20410,20489,1,74,20410,432
30,79,20410,20489,-1,74,20489,8624
30,86,20489,20575,1,74,20489,433
30,86,20489,20575,-1,74,20575,8625
30,144,20575,20719,1,203,20575,434
30,144,20575,20719,-1,203,20719,8626
30,174,20719,20893,1,143,20719,435
30,174,20719,20893,-1,143,20893,8627
30,149,20893,21042,1,170,20893,436
30,149,20893,21042,-1,170,21042,8628
30,137,21042,21179,1,221,21042,437
30,137,21042,21179,-1,221,21179,8629
30,273,21179,21452,1,14,21179,438
30,273,21179,21452,-1,14,21452,8630
30,138,21452,21590,1,239,21452,439
30,138,21452,21590,-1,239,21590,8631
30,137,21590,21727,1,27,21590,440
30,137,21590,21727,-1,27,21727,8632
30,117,21727,21844,1,29,21727,441
30,117,21727,21844,-1,29,21844,8633
30,83,21844,21927,1,2,21844,442
30,83,21844,21927,-1,2,21927,8634
30,234,21927,22161,1,14,21927,443
30,234,21927,22161,-1,14,22161,8635
30,235,22161,22396,1,81,22161,444
30,235,22161,22396,-1,81,22396,8636
30,215,22396,22611,1,120,22396,445
30,215,22396,22611,-1,120,22611,8637
30,221,22611,22832,1,241,22611,446
30,221,22611,22832,-1,241,22832,8638
30,100,22832,22932,1,34,22832,447
30,100,22832,22932,-1,34,22932,8639
30,179,22932,23111,1,181,22932,448
30,179,22932,23111,-1,181,23111,8640
30,149,23111,23260,1,231,23111,449
30,149,23111,23260,-1,231,23260,8641
30,68,23260,23328,1,49,23260,450
30,68,23260,23328,-1,49,23328,8642
30,91,23328,23419,1,109,23328,451
30,91,23328,23419,-1,109,23419,8643
30,109,23419,23528,1,190,23419,452
30,109,23419,23528,-1,190,23528,8644
30,10,23528,23538,1,117,23528,453
30,10,23528,23538,-1,117,23538,8645
30,107,23538,23645,1,246,23538,454
30,107,23538,23645,-1,246,23645,8646
30,115,23645,23760,1,164,23645,455
30,115,23645,23760,-1,164,23760,8647
30,112,23760,23872,1,143,23760,456
30,112,23760,23872,-1,143,23872,8648
30,164,23872,24036,1,6,23872,457
30,164,23872,24036,-1,6,24036,8649
30,74,24036,24110,1,199,24036,458
30,74,24036,24110,-1,199,24110,8650
30,81,24110,24191,1,233,24110,459
30,81,24110,24191,-1,233,24191,8651
30,111,24191,24302,1,26,24191,460
30,111,24191,24302,-1,26,24302,8652
30,107,24302,24409,1,128,24302,461
30,107,24302,24409,-1,128,24409,8653
30,169,24409,24578,1,212,24409,462
30,169,24409,24578,-1,212,24578,8654
30,64,24578,24642,1,92,24578,463
30,64,24578,24642,-1,92,24642,8655
30,254,24642,24896,1,113,24642,464
30,254,24642,24896,-1,113,24896,8656
30,43,24896,24939,1,8,24896,465
30,43,24896,24939,-1,8,24939,8657
30,308,24939,25247,1,77,24939,466
30,308,24939,25247,-1,77,25247,8658
30,88,25247,25335,1,226,25247,467
30,88,25247,25335,-1,226,25335,8659
30,118,25335,25453,1,109,25335,468
30,118,25335,25453,-1,109,25453,8660
30,217,25453,25670,1,10,25453,469
30,217,25453,25670,-1,10,25670,8661
30,190,25670,25860,1,175,25670,470
30,190,25670,25860,-1,175,25860,8662
30,99,25860,25959,1,29,25860,471
30,99,25860,25959,-1,29,25959,8663
30,80,25959,26039,1,148,25959,472
30,80,25959,26039,-1,148,26039,8664
30,127,26039,26166,1,222,26039,473
30,127,26039,26166,-1,222,26166,8665
30,128,26166,26294,1,172,26166,474
30,128,26166,26294,-1,172,26294,8666
30,130,26294,26424,1,44,26294,475
30,130,26294,26424,-1,44,26424,8667
30,215,26424,26639,1,74,26424,476
30,215,26424,26639,-1,74,26639,8668
30,134,26639,26773,1,19,26639,477
30,134,26639,26773,-1,19,26773,8669
30,182,26773,26955,1,242,26773,478
30,182,26773,26955,-1,242,26955,8670
30,102,26955,27057,1,10,26955,479
30,102,26955,27057,-1,10,27057,8671
30,71,27057,27128,1,102,27057,480
30,71,27057,27128,-1,102,27128,8672
30,71,27128,27199,1,50,27128,481
30,71,27128,27199,-1,50,27199,8673
30,68,27199,27267,1,37,27199,482
30,68,27199,27267,-1,37,27267,8674
30,297,27267,27564,1,217,27267,483
30,297,27267,27564,-1,217,27564,8675
30,101,27564,27665,1,3,27564,484
30,101,27564,27665,-1,3,27665,8676
30,64,27665,27729,1,158,27665,485
30,64,27665,27729,-1,158,27729,8677
30,78,27729,27807,1,229,27729,486
30,78,27729,27807,-1,229,27807,8678
30,89,27807,27896,1,69,27807,487
30,89,27807,27896,-1,69,27896,8679
30,204,27896,28100,1,119,27896,488
30,204,27896,28100,-1,119,28100,8680
30,92,28100,28192,1,233,28100,489
30,92,28100,28192,-1,233,28192,8681
30,62,28192,28254,1,1,28192,490
30,62,28192,28254,-1,1,28254,8682
30,66,28254,28320,1,82,28254,491
30,66,28254,28320,-1,82,28320,8683
30,104,28320,28424,1,136,28320,492
30,104,28320,28424,-1,136,28424,8684
30,119,28424,28543,1,100,28424,493
30,119,28424,28543,-1,100,28543,8685
30,102,28543,28645,1,154,28543,494
30,102,28543,28645,-1,154,28645,8686
30,133,28645,28778,1,83,28645,495
30,133,28645,28778,-1,83,28778,8687
30,146,28778,28924,1,193,28778,496
30,146,28778,28924,-1,193,28924,8688
30,134,28924,29058,1,229,28924,497
30,134,28924,29058,-1,229,29058,8689
30,136,29058,29194,1,172,29058,498
30,136,29058,29194,-1,172,29194,8690
30,64,29194,29258,1,54,29194,499
30,64,29194,29258,-1,54,29258,8691
30,112,29258,29370,1,115,29258,500
30,112,29258,29370,-1,115,29370,8692
31,52,0,52,1,229,0,6206
31,52,0,52,-1,229,52,14398
31,125,52,177,1,109,52,6207
31,125,52,177,-1,109,177,14399
31,57,177,234,1,59,177,6208
31,57,177,234,-1,59,234,14400
31,113,234,347,1,47,234,6209
31,113,234,347,-1,47,347,14401
31,114,347,461,1,172,347,6210
31,114,347,461,-1,172,461,14402
31,177,461,638,1,153,461,6211
31,177,461,638,-1,153,638,14403
31,173,638,811,1,104,638,6212
31,173,638,811,-1,104,811,14404
31,206,811,1017,1,233,811,6213
31,206,811,1017,-1,233,1017,14405
31,62,1017,1079,1,154,1017,6214
31,62,1017,1079,-1,154,1079,14406
31,154,1079,1233,1,230,1079,6215
31,154,1079,1233,-1,230,1233,14407
31,58,1233,1291,1,30,1233,6216
31,58,1233,1291,-1,30,1291,14408
31,131,1291,1422,1,140,1291,6217
31,131,1291,1422,-1,140,1422,14409
31,95,1422,1517,1,140,1422,6218
31,95,1422,1517,-1,140,1517,14410
31,52,1517,1569,1,47,1517,6219
31,52,1517,1569,-1,47,1569,14411
31,95,1569,1664,1,68,1569,6220
31,95,1569,1664,-1,68,1664,14412
31,83,1664,1747,1,83,1664,6221
31,83,1664,1747,-1,83,1747,14413
31,67,1747,1814,1,44,1747,6222
31,67,1747,1814,-1,44,1814,14414
31,172,1814,1986,1,130,1814,6223
31,172,1814,1986,-1,130,1986,14415
31,75,1986,2061,1,21,1986,6224
31,75,1986,2061,-1,21,2061,14416
31,87,2061,2148,1,164,2061,6225
31,87,2061,2148,-1,164,2148,14417
31,77,2148,2225,1,86,2148,6226
31,77,2148,2225,-1,86,2225,14418
31,212,2225,2437,1,171,2225,6227
31,212,2225,2437,-1,171,2437,14419
31,60,2437,2497,1,229,2437,6228
31,60,2437,2497,-1,229,2497,14420
31,244,2497,2741,1,34,2497,6229
31,244,2497,2741,-1,34,2741,14421
31,107,2741,2848,1,158,2741,6230
31,107,2741,2848,-1,158,2848,14422
31,108,2848,2956,1,208,2848,6231
31,108,2848,2956,-1,208,2956,14423
31,166,2956,3122,1,133,2956,6232
31,166,2956,3122,-1,133,3122,14424
31,272,3122,3394,1,133,3122,6233
31,272,3122,3394,-1,133,3394,14425
31,201,3394,3595,1,10,3394,6234
31,201,3394,3595,-1,10,3595,14426
31,170,3595,3765,1,255,3595,6235
31,170,3595,3765,-1,255,3765,14427
31,39,3765,3804,1,228,3765,6236
31,39,3765,3804,-1,228,3804,14428
31,133,3804,3937,1,189,3804,6237
31,133,3804,3937,-1,189,3937,14429
31,133,3937,4070,1,23,3937,6238
31,133,3937,4070,-1,23,4070,14430
31,155,4070,4225,1,17,4070,6239
31,155,4070,4225,-1,17,4225,14431
31,59,4225,4284,1,29,4225,6240
31,59,4225,4284,-1,29,4284,14432
31,45,4284,4329,1,20,4284,6241
31,45,4284,4329,-1,20,4329,14433
31,173,4329,4502,1,51,4329,6242
31,173,4329,4502,-1,51,4502,14434
31,120,4502,4622,1,54,4502,6243
31,120,4502,4622,-1,54,4622,14435
31,162,4622,4784,1,12,4622,6244
31,162,4622,4784,-1,12,4784,14436
31,71,4784,4855,1,81,4784,6245
31,71,4784,4855,-1,81,4855,14437
31,225,4855,5080,1,3,4855,6246
31,225,4855,5080,-1,3,5080,14438
31,173,5080,5253,1,54,5080,6247
31,173,5080,5253,-1,54,5253,14439
31,127,5253,5380,1,253,5253,6248
31,127,5253,5380,-1,253,5380,14440
31,43,5380,5423,1,251,5380,6249
31,43,5380,5423,-1,251,5423,14441
31,145,5423,5568,1,66,5423,6250
31,145,5423,5568,-1,66,5568,14442
31,196,5568,5764,1,108,5568,6251
31,196,5568,5764,-1,108,5764,14443
31,129,5764,5893,1,203,5764,6252
31,129,5764,5893,-1,203,5893,14444
31,144,5893,6037,1,228,5893,6253
31,144,5893,6037,-1,228,6037,14445
31,37,6037,6074,1,70,6037,6254
31,37,6037,6074,-1,70,6074,14446
31,104,6074,6178,1,84,6074,6255
31,104,6074,6178,-1,84,6178,14447
31,98,6178,6276,1,152,6178,6256
31,98,6178,6276,-1,152,6276,14448
31,176,6276,6452,1,249,6276,6257
31,176,6276,6452,-1,249,6452,14449
31,98,6452,6550,1,192,6452,6258
31,98,6452,6550,-1,192,6550,14450
31,201,6550,6751,1,162,6550,6259
31,201,6550,6751,-1,162,6751,14451
31,173,6751,6924,1,33,6751,6260
31,173,6751,6924,-1,33,6924,14452
31,91,6924,7015,1,83,6924,6261
31,91,6924,7015,-1,83,7015,14453
31,90,7015,7105,1,133,7015,6262
31,90,7015,7105,-1,133,7105,14454
31,88,7105,7193,1,245,7105,6263
31,88,7105,7193,-1,245,7193,14455
31,92,7193,7285,1,39,7193,6264
31,92,7193,7285,-1,39,7285,14456
31,141,7285,7426,1,163,7285,6265
31,141,7285,7426,-1,163,7426,14457
31,107,7426,7533,1,84,7426,6266
31,107,7426,7533,-1,84,7533,14458
31,126,7533,7659,1,164,7533,6267
31,126,7533,7659,-1,164,7659,14459
31,229,7659,7888,1,3,7659,6268
31,229,7659,7888,-1,3,7888,14460
31,164,7888,8052,1,247,7888,6269
31,164,7888,8052,-1,247,8052,14461
31,132,8052,8184,1,77,8052,6270
31,132,8052,8184,-1,77,8184,14462
31,257,8184,8441,1,59,8184,6271
31,257,8184,8441,-1,59,8441,14463
31,206,8441,8647,1,218,8441,6272
31,206,8441,8647,-1,218,8647,14464
31,237,8647,8884,1,31,8647,6273
31,237,8647,8884,-1,31,8884,14465
31,10,8884,8894,1,127,8884,6274
31,10,8884,8894,-1,127,8894,14466
31,258,8894,9152,1,28,8894,6275
31,258,8894,9152,-1,28,9152,14467
31,115,9152,9267,1,146,9152,6276
31,115,9152,9267,-1,146,9267,14468
31,284,9267,9551,1,174,9267,6277
31,284,9267,9551,-1,174,9551,14469
31,172,9551,9723,1,198,9551,6278
31,172,9551,9723,-1,198,9723,14470
31,81,9723,9804,1,252,9723,6279
31,81,9723,9804,-1,252,9804,14471
31,68,9804,9872,1,134,9804,6280
31,68,9804,9872,-1,134,9872,14472
31,177,9872,10049,1,244,9872,6281
31,177,9872,10049,-1,244,10049,14473
31,158,10049,10207,1,107,10049,6282
31,158,10049,10207,-1,107,10207,14474
31,99,10207,10306,1,246,10207,6283
31,99,10207,10306,-1,246,10306,14475
31,34,10306,10340,1,119,10306,6284
31,34,10306,10340,-1,119,10340,14476
31,97,10340,10437,1,169,10340,6285
31,97,10340,10437,-1,169,10437,14477
31,80,10437,10517,1,202,10437,6286
31,80,10437,10517,-1,202,10517,14478
31,117,10517,10634,1,202,10517,6287
31,117,10517,10634,-1,202,10634,14479
31,91,10634,10725,1,74,10634,6288
31,91,10634,10725,-1,74,10725,14480
31,104,10725,10829,1,1,10725,6289
31,104,10725,10829,-1,1,10829,14481
31,68,10829,10897,1,170,10829,6290
31,68,10829,10897,-1,170,10897,14482
31,181,10897,11078,1,174,10897,6291
31,181,10897,11078,-1,174,11078,14483
31,165,11078,11243,1,96,11078,6292
31,165,11078,11243,-1,96,11243,14484
31,278,11243,11521,1,209,11243,6293
31,278,11243,11521,-1,209,11521,14485
31,111,11521,11632,1,89,11521,6294
31,111,11521,11632,-1,89,11632,14486
31,130,11632,11762,1,99,11632,6295
31,130,11632,11762,-1,99,11762,14487
31,117,11762,11879,1,84,11762,6296
31,117,11762,11879,-1,84,11879,14488
31,218,11879,12097,1,80,11879,6297
31,218,11879,12097,-1,80,12097,14489
31,43,12097,12140,1,131,12097,6298
31,43,12097,12140,-1,131,12140,14490
31,81,12140,12221,1,45,12140,6299
31,81,12140,12221,-1,45,12221,14491
31,54,12221,12275,1,65,12221,6300
31,54,12221,12275,-1,65,12275,14492
31,104,12275,12379,1,44,12275,6301
31,104,12275,12379,-1,44,12379,14493
31,142,12379,12521,1,155,12379,6302
31,142,12379,12521,-1,155,12521,14494
31,151,12521,12672,1,106,12521,6303
31,151,12521,12672,-1,106,12672,14495
31,70,12672,12742,1,207,12672,6304
31,70,12672,12742,-1,207,12742,14496
31,101,12742,12843,1,255,12742,6305
31,101,12742,12843,-1,255,12843,14497
31,167,12843,13010,1,199,12843,6306
31,167,12843,13010,-1,199,13010,14498
31,99,13010,13109,1,237,13010,6307
31,99,13010,13109,-1,237,13109,14499
31,134,13109,13243,1,202,13109,6308
31,134,13109,13243,-1,202,13243,14500
31,70,13243,13313,1,39,13243,6309
31,70,13243,13313,-1,39,13313,14501
31,39,13313,13352,1,67,13313,6310
31,39,13313,13352,-1,67,13352,14502
31,64,13352,13416,1,197,13352,6311
31,64,13352,13416,-1,197,13416,14503
31,71,13416,13487,1,214,13416,6312
31,71,13416,13487,-1,214,13487,14504
31,28,13487,13515,1,94,13487,6313
31,28,13487,13515,-1,94,13515,14505
31,61,13515,13576,1,116,13515,6314
31,61,13515,13576,-1,116,13576,14506
31,84,13576,13660,1,202,13576,6315
31,84,13576,13660,-1,202,13660,14507
31,108,13660,13768,1,52,13660,6316
31,108,13660,13768,-1,52,13768,14508
31,51,13768,13819,1,41,13768,6317
31,51,13768,13819,-1,41,13819,14509
31,19,13819,13838,1,240,13819,6318
31,19,13819,13838,-1,240,13838,14510
31,162,13838,14000,1,152,13838,6319
31,162,13838,14000,-1,152,14000,14511
31,203,14000,14203,1,157,14000,6320
31,203,14000,14203,-1,157,14203,14512
31,193,14203,14396,1,118,14203,6321
31,193,14203,14396,-1,118,14396,14513
31,135,14396,14531,1,197,14396,6322
31,135,14396,14531,-1,197,14531,14514
31,268,14531,14799,1,134,14531,6323
31,268,14531,14799,-1,134,14799,14515
31,140,14799,14939,1,71,14799,6324
31,140,14799,14939,-1,71,14939,14516
31,151,14939,15090,1,167,14939,6325
31,151,14939,15090,-1,167,15090,14517
31,138,15090,15228,1,19,15090,6326
31,138,15090,15228,-1,19,15228,14518
31,97,15228,15325,1,101,15228,6327
31,97,15228,15325,-1,101,15325,14519
31,148,15325,15473,1,219,15325,6328
31,148,15325,15473,-1,219,15473,14520
31,162,15473,15635,1,183,15473,6329
31,162,15473,15635,-1,183,15635,14521
31,110,15635,15745,1,197,15635,6330
31,110,15635,15745,-1,197,15745,14522
31,217,15745,15962,1,159,15745,6331
31,217,15745,15962,-1,159,15962,14523
31,165,15962,16127,1,90,15962,6332
31,165,15962,16127,-1,90,16127,14524
31,156,16127,16283,1,229,16127,6333
31,156,16127,16283,-1,229,16283,14525
31,44,16283,16327,1,99,16283,6334
31,44,16283,16327,-1,99,16327,14526
31,123,16327,16450,1,129,16327,6335
31,123,16327,16450,-1,129,16450,14527
31,92,16450,16542,1,179,16450,6336
31,92,16450,16542,-1,179,16542,14528
31,31,16542,16573,1,183,16542,6337
31,31,16542,16573,-1,183,16573,14529
31,227,16573,16800,1,178,16573,6338
31,227,16573,16800,-1,178,16800,14530
31,299,16800,17099,1,123,16800,6339
31,299,16800,17099,-1,123,17099,14531
31,97,17099,17196,1,4,17099,6340
31,97,17099,17196,-1,4,17196,14532
31,315,17196,17511,1,113,17196,6341
31,315,17196,17511,-1,113,17511,14533
31,34,17511,17545,1,246,17511,6342
31,34,17511,17545,-1,246,17545,14534
31,148,17545,17693,1,182,17545,6343
31,148,17545,17693,-1,182,17693,14535
31,67,17693,17760,1,3,17693,6344
31,67,17693,17760,-1,3,17760,14536
31,161,17760,17921,1,57,17760,6345
31,161,17760,17921,-1,57,17921,14537
31,52,17921,17973,1,163,17921,6346
31,52,17921,17973,-1,163,17973,14538
31,154,17973,18127,1,48,17973,6347
31,154,17973,18127,-1,48,18127,14539
31,321,18127,18448,1,247,18127,6348
31,321,18127,18448,-1,247,18448,14540
31,131,18448,18579,1,248,18448,6349
31,131,18448,18579,-1,248,18579,14541
31,69,18579,18648,1,87,18579,6350
31,69,18579,18648,-1,87,18648,14542
31,190,18648,18838,1,155,18648,6351
31,190,18648,18838,-1,155,18838,14543
31,226,18838,19064,1,11,18838,6352
31,226,18838,19064,-1,11,19064,14544
31,117,19064,19181,1,101,19064,6353
31,117,19064,19181,-1,101,19181,14545
31,127,19181,19308,1,125,19181,6354
31,127,19181,19308,-1,125,19308,14546
31,89,19308,19397,1,240,19308,6355
31,89,19308,19397,-1,240,19397,14547
31,99,19397,19496,1,54,19397,6356
31,99,19397,19496,-1,54,19496,14548
31,118,19496,19614,1,17,19496,6357
31,118,19496,19614,-1,17,19614,14549
31,254,19614,19868,1,230,19614,6358
31,254,19614,19868,-1,230,19868,14550
31,214,19868,20082,1,16,19868,6359
31,214,19868,20082,-1,16,20082,14551
31,50,20082,20132,1,222,20082,6360
31,50,20082,20132,-1,222,20132,14552
31,138,20132,20270,1,93,20132,6361
31,138,20132,20270,-1,93,20270,14553
31,94,20270,20364,1,47,20270,6362
31,94,20270,20364,-1,47,20364,14554
31,63,20364,20427,1,163,20364,6363
31,63,20364,20427,-1,163,20427,14555
31,126,20427,20553,1,133,20427,6364
31,126,20427,20553,-1,133,20553,14556
31,106,20553,20659,1,73,20553,6365
31,106,20553,20659,-1,73,20659,14557
31,122,20659,20781,1,169,20659,6366
31,122,20659,20781,-1,169,20781,14558
31,222,20781,21003,1,241,20781,6367
31,222,20781,21003,-1,241,21003,14559
31,75,21003,21078,1,105,21003,6368
31,75,21003,21078,-1,105,21078,14560
31,263,21078,21341,1,128,21078,6369
31,263,21078,21341,-1,128,21341,14561
31,126,21341,21467,1,247,21341,6370
31,126,21341,21467,-1,247,21467,14562
31,127,21467,21594,1,224,21467,6371
31,127,21467,21594,-1,224,21594,14563
31,165,21594,21759,1,100,21594,6372
31,165,21594,21759,-1,100,21759,14564
31,169,21759,21928,1,108,21759,6373
31,169,21759,21928,-1,108,21928,14565
31,92,21928,22020,1,114,21928,6374
31,92,21928,22020,-1,114,22020,14566
31,79,22020,22099,1,219,22020,6375
31,79,22020,22099,-1,219,22099,14567
31,97,22099,22196,1,18,22099,6376
31,97,22099,22196,-1,18,22196,14568
31,224,22196,22420,1,4,22196,6377
31,224,22196,22420,-1,4,22420,14569
31,178,22420,22598,1,135,22420,6378
31,178,22420,22598,-1,135,22598,14570
31,106,22598,22704,1,133,22598,6379
31,106,22598,22704,-1,133,22704,14571
31,63,22704,22767,1,231,22704,6380
31,63,22704,22767,-1,231,22767,14572
31,132,22767,22899,1,232,22767,6381
31,132,22767,22899,-1,232,22899,14573
31,142,22899,23041,1,137,22899,6382
31,142,22899,23041,-1,137,23041,14574
31,140,23041,23181,1,167,23041,6383
31,140,23041,23181,-1,167,23181,14575
31,140,23181,23321,1,66,23181,6384
31,140,23181,23321,-1,66,23321,14576
31,160,23321,23481,1,97,23321,6385
31,160,23321,23481,-1,97,23481,14577
31,120,23481,23601,1,103,23481,6386
31,120,23481,23601,-1,103,23601,14578
31,183,23601,23784,1,118,23601,6387
31,183,23601,23784,-1,118,23784,14579
31,111,23784,23895,1,178,23784,6388
31,111,23784,23895,-1,178,23895,14580
31,216,23895,24111,1,59,23895,6389
31,216,23895,24111,-1,59,24111,14581
31,76,24111,24187,1,218,24111,6390
31,76,24111,24187,-1,218,24187,14582
31,113,24187,24300,1,189,24187,6391
31,113,24187,24300,-1,189,24300,14583
31,122,24300,24422,1,114,24300,6392
31,122,24300,24422,-1,114,24422,14584
31,98,24422,24520,1,195,24422,6393
31,98,24422,24520,-1,195,24520,14585
31,90,24520,24610,1,118,24520,6394
31,90,24520,24610,-1,118,24610,14586
31,62,24610,24672,1,202,24610,6395
31,62,24610,24672,-1,202,24672,14587
31,84,24672,24756,1,72,24672,6396
31,84,24672,24756,-1,72,24756,14588
31,159,24756,24915,1,18,24756,6397
31,159,24756,24915,-1,18,24915,14589
31,70,24915,24985,1,36,24915,6398
31,70,24915,24985,-1,36,24985,14590
31,40,24985,25025,1,21,24985,6399
31,40,24985,25025,-1,21,25025,14591
31,152,25025,25177,1,240,25025,6400
31,152,25025,25177,-1,240,25177,14592
31,68,25177,25245,1,119,25177,6401
31,68,25177,25245,-1,119,25245,14593
31,24,25245,25269,1,219,25245,6402
31,24,25245,25269,-1,219,25269,14594
31,101,25269,25370,1,123,25269,6403
31,101,25269,25370,-1,123,25370,14595
31,97,25370,25467,1,141,25370,6404
31,97,25370,25467,-1,141,25467,14596
31,130,25467,25597,1,85,25467,6405
31,130,25467,25597,-1,85,25597,14597
31,238,25597,25835,1,145,25597,6406
31,238,25597,25835,-1,145,25835,14598
31,148,25835,25983,1,212,25835,6407
31,148,25835,25983,-1,212,25983,14599
31,111,25983,26094,1,183,25983,6408
31,111,25983,26094,-1,183,26094,14600
31,85,26094,26179,1,119,26094,6409
31,85,26094,26179,-1,119,26179,14601
31,148,26179,26327,1,133,26179,6410
31,148,26179,26327,-1,133,26327,14602
31,99,26327,26426,1,151,26327,6411
31,99,26327,26426,-1,151,26426,14603
31,187,26426,26613,1,1,26426,6412
31,187,26426,26613,-1,1,26613,14604
31,283,26613,26896,1,152,26613,6413
31,283,26613,26896,-1,152,26896,14605
31,113,26896,27009,1,172,26896,6414
31,113,26896,27009,-1,172,27009,14606
31,152,27009,27161,1,249,27009,6415
31,152,27009,27161,-1,249,27161,14607
31,177,27161,27338,1,86,27161,6416
31,177,27161,27338,-1,86,27338,14608
31,81,27338,27419,1,59,27338,6417
31,81,27338,27419,-1,59,27419,14609
31,118,27419,27537,1,62,27419,6418
31,118,27419,27537,-1,62,27537,14610
31,137,27537,27674,1,145,27537,6419
31,137,27537,27674,-1,145,27674,14611
31,93,27674,27767,1,87,27674,6420
31,93,27674,27767,-1,87,27767,14612
31,132,27767,27899,1,176,27767,6421
31,132,27767,27899,-1,176,27899,14613
31,68,27899,27967,1,171,27899,6422
31,68,27899,27967,-1,171,27967,14614
31,111,27967,28078,1,42,27967,6423
31,111,27967,28078,-1,42,28078,14615
31,99,28078,28177,1,84,28078,6424
31,99,28078,28177,-1,84,28177,14616
31,166,28177,28343,1,154,28177,6425
31,166,28177,28343,-1,154,28343,14617
31,68,28343,28411,1,206,28343,6426
31,68,28343,28411,-1,206,28411,14618
31,40,28411,28451,1,77,28411,6427
31,40,28411,28451,-1,77,28451,14619
31,71,28451,28522,1,26,28451,6428
31,71,28451,28522,-1,26,28522,14620
31,26,28522,28548,1,11,28522,6429
31,26,28522,28548,-1,11,28548,14621
31,57,28548,28605,1,241,28548,6430
31,57,28548,28605,-1,241,28605,14622
31,93,28605,28698,1,213,28605,6431
31,93,28605,28698,-1,213,28698,14623
31,334,28698,29032,1,233,28698,6432
31,334,28698,29032,-1,233,29032,14624
31,111,29032,29143,1,215,29032,6433
31,111,29032,29143,-1,215,29143,14625
31,163,29143,29306,1,4,29143,6434
31,163,29143,29306,-1,4,29306,14626
31,147,29306,29453,1,83,29306,6435
31,147,29306,29453,-1,83,29453,14627
31,92,29453,29545,1,133,29453,6436
31,92,29453,29545,-1,133,29545,14628
31,138,29545,29683,1,121,29545,6437
31,138,29545,29683,-1,121,29683,14629
31,117,29683,29800,1,121,29683,6438
31,117,29683,29800,-1,121,29800,14630
31,163,29800,29963,1,173,29800,6439
31,163,29800,29963,-1,173,29963,14631
31,38,29963,30001,1,173,29963,6440
31,38,29963,30001,-1,173,30001,14632
31,276,30001,30277,1,131,30001,6441
31,276,30001,30277,-1,131,30277,14633
31,238,30277,30515,1,115,30277,6442
31,238,30277,30515,-1,115,30515,14634
31,102,30515,30617,1,58,30515,6443
31,102,30515,30617,-1,58,30617,14635
31,161,30617,30778,1,33,30617,6444
31,161,30617,30778,-1,33,30778,14636
31,203,30778,30981,1,157,30778,6445
31,203,30778,30981,-1,157,30981,14637
31,148,30981,31129,1,223,30981,6446
31,148,30981,31129,-1,223,31129,14638
31,36,31129,31165,1,236,31129,6447
31,36,31129,31165,-1,236,31165,14639
31,64,31165,31229,1,10,31165,6448
31,64,31165,31229,-1,10,31229,14640
31,141,31229,31370,1,150,31229,6449
31,141,31229,31370,-1,150,31370,14641
31,115,31370,31485,1,114,31370,6450
31,115,31370,31485,-1,114,31485,14642
31,57,31485,31542,1,24,31485,6451
31,57,31485,31542,-1,24,31542,14643
31,91,31542,31633,1,132,31542,6452
31,91,31542,31633,-1,132,31633,14644
31,235,31633,31868,1,35,31633,6453
31,235,31633,31868,-1,35,31868,14645
31,120,31868,31988,1,158,31868,6454
31,120,31868,31988,-1,158,31988,14646
31,191,31988,32179,1,138,31988,6455
31,191,31988,32179,-1,138,32179,14647
31,97,32179,32276,1,56,32179,6456
31,97,32179,32276,-1,56,32276,14648
31,114,32276,32390,1,221,32276,6457
31,114,32276,32390,-1,221,32390,14649
31,82,32390,32472,1,117,32390,6458
31,82,32390,32472,-1,117,32472,14650
31,187,32472,32659,1,46,32472,6459
31,187,32472,32659,-1,46,32659,14651
31,63,32659,32722,1,112,32659,6460
31,63,32659,32722,-1,112,32722,14652
31,154,32722,32876,1,166,32722,6461
31,154,32722,32876,-1,166,32876,14653
31,137,32876,33013,1,53,32876,6462
31,137,32876,33013,-1,53,33013,14654
31,145,33013,33158,1,164,33013,6463
31,145,33013,33158,-1,164,33158,14655
31,62,33158,33220,1,71,33158,6464
31,62,33158,33220,-1,71,33220,14656
31,59,33220,33279,1,92,33220,6465
31,59,33220,33279,-1,92,33279,14657
31,164,33279,33443,1,25,33279,6466
31,164,33279,33443,-1,25,33443,14658
31,103,33443,33546,1,95,33443,6467
31,103,33443,33546,-1,95,33546,14659
31,171,33546,33717,1,224,33546,6468
31,171,33546,33717,-1,224,33717,14660
31,79,33717,33796,1,217,33717,6469
31,79,33717,33796,-1,217,33796,14661
31,115,33796,33911,1,221,33796,6470
31,115,33796,33911,-1,221,33911,14662
31,157,33911,34068,1,53,33911,6471
31,157,33911,34068,-1,53,34068,14663
31,43,34068,34111,1,132,34068,6472
31,43,34068,34111,-1,132,34111,14664
31,232,34111,34343,1,66,34111,6473
31,232,34111,34343,-1,66,34343,14665
31,65,34343,34408,1,17,34343,6474
31,65,34343,34408,-1,17,34408,14666
31,143,34408,34551,1,228,34408,6475
31,143,34408,34551,-1,228,34551,14667
31,114,34551,34665,1,18,34551,6476
31,114,34551,34665,-1,18,34665,14668
31,181,34665,34846,1,81,34665,6477
31,181,34665,34846,-1,81,34846,14669
31,238,34846,35084,1,211,34846,6478
31,238,34846,35084,-1,211,35084,14670
31,121,35084,35205,1,243,35084,6479
31,121,35084,35205,-1,243,35205,14671
31,75,35205,35280,1,55,35205,6480
31,75,35205,35280,-1,55,35280,14672
32,63,0,63,1,8,0,7473
32,63,0,63,-1,8,63,15665
32,92,63,155,1,150,63,7474
32,92,63,155,-1,150,155,15666
32,58,155,213,1,120,155,7475
32,58,155,213,-1,120,213,15667
32,77,213,290,1,180,213,7476
32,77,213,290,-1,180,290,15668
32,114,290,404,1,191,290,7477
32,114,290,404,-1,191,404,15669
32,49,404,453,1,165,404,7478
32,49,404,453,-1,165,453,15670
32,149,453,602,1,57,453,7479
32,149,453,602,-1,57,602,15671
32,175,602,777,1,23,602,7480
32,175,602,777,-1,23,777,15672
32,54,777,831,1,226,777,7481
32,54,777,831,-1,226,831,15673
32,134,831,965,1,28,831,7482
32,134,831,965,-1,28,965,15674
32,157,965,1122,1,22,965,7483
32,157,965,1122,-1,22,1122,15675
32,230,1122,1352,1,111,1122,7484
32,230,1122,1352,-1,111,1352,15676
32,288,1352,1640,1,56,1352,7485
32,288,1352,1640,-1,56,1640,15677
32,112,1640,1752,1,31,1640,7486
32,112,1640,1752,-1,31,1752,15678
32,181,1752,1933,1,66,1752,7487
32,181,1752,1933,-1,66,1933,15679
32,168,1933,2101,1,210,1933,7488
32,168,1933,2101,-1,210,2101,15680
32,345,2101,2446,1,125,2101,7489
32,345,2101,2446,-1,125,2446,15681
32,152,2446,2598,1,189,2446,7490
32,152,2446,2598,-1,189,2598,15682
32,242,2598,2840,1,232,2598,7491
32,242,2598,2840,-1,232,2840,15683
32,44,2840,2884,1,53,2840,7492
32,44,2840,2884,-1,53,2884,15684
32,123,2884,3007,1,10,2884,7493
32,123,2884,3007,-1,10,3007,15685
32,83,3007,3090,1,72,3007,7494
32,83,3007,3090,-1,72,3090,15686
32,42,3090,3132,1,229,3090,7495
32,42,3090,3132,-1,229,3132,15687
32,120,3132,3252,1,167,3132,7496
32,120,3132,3252,-1,167,3252,15688
32,121,3252,3373,1,104,3252,7497
32,121,3252,3373,-1,104,3373,15689
32,195,3373,3568,1,132,3373,7498
32,195,3373,3568,-1,132,3568,15690
32,121,3568,3689,1,33,3568,7499
32,121,3568,3689,-1,33,3689,15691
32,187,3689,3876,1,103,3689,7500
32,187,3689,3876,-1,103,3876,15692
32,178,3876,4054,1,65,3876,7501
32,178,3876,4054,-1,65,4054,15693
32,107,4054,4161,1,175,4054,7502
32,107,4054,4161,-1,175,4161,15694
32,145,4161,4306,1,173,4161,7503
32,145,4161,4306,-1,173,4306,15695
32,146,4306,4452,1,17,4306,7504
32,146,4306,4452,-1,17,4452,15696
32,54,4452,4506,1,107,4452,7505
32,54,4452,4506,-1,107,4506,15697
32,93,4506,4599,1,91,4506,7506
32,93,4506,4599,-1,91,4599,15698
32,115,4599,4714,1,50,4599,7507
32,115,4599,4714,-1,50,4714,15699
32,65,4714,4779,1,147,4714,7508
32,65,4714,4779,-1,147,4779,15700
32,202,4779,4981,1,48,4779,7509
32,202,4779,4981,-1,48,4981,15701
32,94,4981,5075,1,252,4981,7510
32,94,4981,5075,-1,252,5075,15702
32,135,5075,5210,1,155,5075,7511
32,135,5075,5210,-1,155,5210,15703
32,119,5210,5329,1,245,5210,7512
32,119,5210,5329,-1,245,5329,15704
32,105,5329,5434,1,21,5329,7513
32,105,5329,5434,-1,21,5434,15705
32,160,5434,5594,1,216,5434,7514
32,160,5434,5594,-1,216,5594,15706
32,101,5594,5695,1,247,5594,7515
32,101,5594,5695,-1,247,5695,15707
32,100,5695,5795,1,167,5695,7516
32,100,5695,5795,-1,167,5795,15708
32,136,5795,5931,1,149,5795,7517
32,136,5795,5931,-1,149,5931,15709
32,139,5931,6070,1,24,5931,7518
32,139,5931,6070,-1,24,6070,15710
32,149,6070,6219,1,227,6070,7519
32,149,6070,6219,-1,227,6219,15711
32,30,6219,6249,1,67,6219,7520
32,30,6219,6249,-1,67,6249,15712
32,61,6249,6310,1,43,6249,7521
32,61,6249,6310,-1,43,6310,15713
32,96,6310,6406,1,163,6310,7522
32,96,6310,6406,-1,163,6406,15714
32,84,6406,6490,1,62,6406,7523
32,84,6406,6490,-1,62,6490,15715
32,84,6490,6574,1,130,6490,7524
32,84,6490,6574,-1,130,6574,15716
32,165,6574,6739,1,101,6574,7525
32,165,6574,6739,-1,101,6739,15717
32,120,6739,6859,1,231,6739,7526
32,120,6739,6859,-1,231,6859,15718
32,215,6859,7074,1,57,6859,7527
32,215,6859,7074,-1,57,7074,15719
32,30,7074,7104,1,142,7074,7528
32,30,7074,7104,-1,142,7104,15720
32,138,7104,7242,1,40,7104,7529
32,138,7104,7242,-1,40,7242,15721
32,65,7242,7307,1,104,7242,7530
32,65,7242,7307,-1,104,7307,15722
32,107,7307,7414,1,130,7307,7531
32,107,7307,7414,-1,130,7414,15723
32,148,7414,7562,1,164,7414,7532
32,148,7414,7562,-1,164,7562,15724
32,103,7562,7665,1,93,7562,7533
32,103,7562,7665,-1,93,7665,15725
32,53,7665,7718,1,7,7665,7534
32,53,7665,7718,-1,7,7718,15726
32,43,7718,7761,1,2,7718,7535
32,43,7718,7761,-1,2,7761,15727
32,132,7761,7893,1,145,7761,7536
32,132,7761,7893,-1,145,7893,15728
32,186,7893,8079,1,193,7893,7537
32,186,7893,8079,-1,193,8079,15729
32,49,8079,8128,1,33,8079,7538
32,49,8079,8128,-1,33,8128,15730
32,61,8128,8189,1,33,8128,7539
32,61,8128,8189,-1,33,8189,15731
32,178,8189,8367,1,200,8189,7540
32,178,8189,8367,-1,200,8367,15732
32,71,8367,8438,1,100,8367,7541
32,71,8367,8438,-1,100,8438,15733
32,166,8438,8604,1,11,8438,7542
32,166,8438,8604,-1,11,8604,15734
32,71,8604,8675,1,189,8604,7543
32,71,8604,8675,-1,189,8675,15735
32,108,8675,8783,1,169,8675,7544
32,108,8675,8783,-1,169,8783,15736
32,172,8783,8955,1,70,8783,7545
32,172,8783,8955,-1,70,8955,15737
32,194,8955,9149,1,238,8955,7546
32,194,8955,9149,-1,238,9149,15738
32,211,9149,9360,1,240,9149,7547
32,211,9149,9360,-1,240,9360,15739
32,81,9360,9441,1,69,9360,7548
32,81,9360,9441,-1,69,9441,15740
32,116,9441,9557,1,94,9441,7549
32,116,9441,9557,-1,94,9557,15741
32,80,9557,9637,1,161,9557,7550
32,80,9557,9637,-1,161,9637,15742
32,63,9637,9700,1,71,9637,7551
32,63,9637,9700,-1,71,9700,15743
32,220,9700,9920,1,67,9700,7552
32,220,9700,9920,-1,67,9920,15744
32,128,9920,10048,1,227,9920,7553
32,128,9920,10048,-1,227,10048,15745
32,244,10048,10292,1,238,10048,7554
32,244,10048,10292,-1,238,10292,15746
32,156,10292,10448,1,27,10292,7555
32,156,10292,10448,-1,27,10448,15747
32,41,10448,10489,1,31,10448,7556
32,41,10448,10489,-1,31,10489,15748
32,102,10489,10591,1,118,10489,7557
32,102,10489,10591,-1,118,10591,15749
32,44,10591,10635,1,168,10591,7558
32,44,10591,10635,-1,168,10635,15750
32,47,10635,10682,1,152,10635,7559
32,47,10635,10682,-1,152,10682,15751
32,136,10682,10818,1,225,10682,7560
32,136,10682,10818,-1,225,10818,15752
32,136,10818,10954,1,125,10818,7561
32,136,10818,10954,-1,125,10954,15753
32,22,10954,10976,1,22,10954,7562
32,22,10954,10976,-1,22,10976,15754
32,143,10976,11119,1,89,10976,7563
32,143,10976,11119,-1,89,11119,15755
32,80,11119,11199,1,15,11119,7564
32,80,11119,11199,-1,15,11199,15756
32,14,11199,11213,1,213,11199,7565
32,14,11199,11213,-1,213,11213,15757
32,177,11213,11390,1,175,11213,7566
32,177,11213,11390,-1,175,11390,15758
32,115,11390,11505,1,69,11390,7567
32,115,11390,11505,-1,69,11505,15759
32,110,11505,11615,1,12,11505,7568
32,110,11505,11615,-1,12,11615,15760
32,84,11615,11699,1,171,11615,7569
32,84,11615,11699,-1,171,11699,15761
32,167,11699,11866,1,85,11699,7570
32,167,11699,11866,-1,85,11866,15762
32,147,11866,12013,1,20,11866,7571
32,147,11866,12013,-1,20,12013,15763
32,218,12013,12231,1,216,12013,7572
32,218,12013,12231,-1,216,12231,15764
32,179,12231,12410,1,85,12231,7573
32,179,12231,12410,-1,85,12410,15765
32,58,12410,12468,1,52,12410,7574
32,58,12410,12468,-1,52,12468,15766
32,42,12468,12510,1,13,12468,7575
32,42,12468,12510,-1,13,12510,15767
32,220,12510,12730,1,138,12510,7576
32,220,12510,12730,-1,138,12730,15768
32,83,12730,12813,1,224,12730,7577
32,83,12730,12813,-1,224,12813,15769
32,225,12813,13038,1,29,12813,7578
32,225,12813,13038,-1,29,13038,15770
32,102,13038,13140,1,183,13038,7579
32,102,13038,13140,-1,183,13140,15771
32,282,13140,13422,1,139,13140,7580
32,282,13140,13422,-1,139,13422,15772
32,161,13422,13583,1,146,13422,7581
32,161,13422,13583,-1,146,13583,15773
32,74,13583,13657,1,86,13583,7582
32,74,13583,13657,-1,86,13657,15774
32,121,13657,13778,1,171,13657,7583
32,121,13657,13778,-1,171,13778,15775
32,221,13778,13999,1,230,13778,7584
32,221,13778,13999,-1,230,13999,15776
32,258,13999,14257,1,35,13999,7585
32,258,13999,14257,-1,35,14257,15777
32,127,14257,14384,1,196,14257,7586
32,127,14257,14384,-1,196,14384,15778
32,142,14384,14526,1,99,14384,7587
32,142,14384,14526,-1,99,14526,15779
32,192,14526,14718,1,34,14526,7588
32,192,14526,14718,-1,34,14718,15780
32,107,14718,14825,1,146,14718,7589
32,107,14718,14825,-1,146,14825,15781
32,108,14825,14933,1,109,14825,7590
32,108,14825,14933,-1,109,14933,15782
32,41,14933,14974,1,32,14933,7591
32,41,14933,14974,-1,32,14974,15783
32,58,14974,15032,1,48,14974,7592
32,58,14974,15032,-1,48,15032,15784
32,191,15032,15223,1,35,15032,7593
32,191,15032,15223,-1,35,15223,15785
32,63,15223,15286,1,201,15223,7594
32,63,15223,15286,-1,201,15286,15786
32,156,15286,15442,1,160,15286,7595
32,156,15286,15442,-1,160,15442,15787
32,101,15442,15543,1,211,15442,7596
32,101,15442,15543,-1,211,15543,15788
32,105,15543,15648,1,218,15543,7597
32,105,15543,15648,-1,218,15648,15789
32,192,15648,15840,1,252,15648,7598
32,192,15648,15840,-1,252,15840,15790
32,391,15840,16231,1,86,15840,7599
32,391,15840,16231,-1,86,16231,15791
32,170,16231,16401,1,229,16231,7600
32,170,16231,16401,-1,229,16401,15792
32,287,16401,16688,1,9,16401,7601
32,287,16401,16688,-1,9,16688,15793
32,191,16688,16879,1,119,16688,7602
32,191,16688,16879,-1,119,16879,15794
32,144,16879,17023,1,72,16879,7603
32,144,16879,17023,-1,72,17023,15795
32,87,17023,17110,1,94,17023,7604
32,87,17023,17110,-1,94,17110,15796
32,57,17110,17167,1,91,17110,7605
32,57,17110,17167,-1,91,17167,15797
32,99,17167,17266,1,164,17167,7606
32,99,17167,17266,-1,164,17266,15798
32,119,17266,17385,1,194,17266,7607
32,119,17266,17385,-1,194,17385,15799
32,226,17385,17611,1,225,17385,7608
32,226,17385,17611,-1,225,17611,15800
32,147,17611,17758,1,48,17611,7609
32,147,17611,17758,-1,48,17758,15801
32,225,17758,17983,1,202,17758,7610
32,225,17758,17983,-1,202,17983,15802
32,153,17983,18136,1,7,17983,7611
32,153,17983,18136,-1,7,18136,15803
32,69,18136,18205,1,151,18136,7612
32,69,18136,18205,-1,151,18205,15804
32,62,18205,18267,1,224,18205,7613
32,62,18205,18267,-1,224,18267,15805
32,208,18267,18475,1,39,18267,7614
32,208,18267,18475,-1,39,18475,15806
32,68,18475,18543,1,174,18475,7615
32,68,18475,18543,-1,174,18543,15807
32,60,18543,18603,1,53,18543,7616
32,60,18543,18603,-1,53,18603,15808
32,89,18603,18692,1,63,18603,7617
32,89,18603,18692,-1,63,18692,15809
32,81,18692,18773,1,35,18692,7618
32,81,18692,18773,-1,35,18773,15810
32,28,18773,18801,1,110,18773,7619
32,28,18773,18801,-1,110,18801,15811
32,109,18801,18910,1,248,18801,7620
32,109,18801,18910,-1,248,18910,15812
32,43,18910,18953,1,101,18910,7621
32,43,18910,18953,-1,101,18953,15813
32,83,18953,19036,1,128,18953,7622
32,83,18953,19036,-1,128,19036,15814
32,63,19036,19099,1,148,19036,7623
32,63,19036,19099,-1,148,19099,15815
32,238,19099,19337,1,191,19099,7624
32,238,19099,19337,-1,191,19337,15816
32,72,19337,19409,1,13,19337,7625
32,72,19337,19409,-1,13,19409,15817
32,133,19409,19542,1,28,19409,7626
32,133,19409,19542,-1,28,19542,15818
32,263,19542,19805,1,138,19542,7627
32,263,19542,19805,-1,138,19805,15819
32,108,19805,19913,1,127,19805,7628
32,108,19805,19913,-1,127,19913,15820
32,98,19913,20011,1,129,19913,7629
32,98,19913,20011,-1,129,20011,15821
32,153,20011,20164,1,178,20011,7630
32,153,20011,20164,-1,178,20164,15822
32,196,20164,20360,1,209,20164,7631
32,196,20164,20360,-1,209,20360,15823
32,146,20360,20506,1,1,20360,7632
32,146,20360,20506,-1,1,20506,15824
32,232,20506,20738,1,78,20506,7633
32,232,20506,20738,-1,78,20738,15825
32,301,20738,21039,1,64,20738,7634
32,301,20738,21039,-1,64,21039,15826
32,168,21039,21207,1,118,21039,7635
32,168,21039,21207,-1,118,21207,15827
32,60,21207,21267,1,135,21207,7636
32,60,21207,21267,-1,135,21267,15828
32,127,21267,21394,1,115,21267,7637
32,127,21267,21394,-1,115,21394,15829
32,115,21394,21509,1,194,21394,7638
32,115,21394,21509,-1,194,21509,15830
32,158,21509,21667,1,59,21509,7639
32,158,21509,21667,-1,59,21667,15831
32,51,21667,21718,1,221,21667,7640
32,51,21667,21718,-1,221,21718,15832
32,245,21718,21963,1,73,21718,7641
32,245,21718,21963,-1,73,21963,15833
32,90,21963,22053,1,141,21963,7642
32,90,21963,22053,-1,141,22053,15834
32,74,22053,22127,1,154,22053,7643
32,74,22053,22127,-1,154,22127,15835
32,86,22127,22213,1,159,22127,7644
32,86,22127,22213,-1,159,22213,15836
32,118,22213,22331,1,107,22213,7645
32,118,22213,22331,-1,107,22331,15837
32,176,22331,22507,1,38,22331,7646
32,176,22331,22507,-1,38,22507,15838
32,158,22507,22665,1,256,22507,7647
32,158,22507,22665,-1,256,22665,15839
32,159,22665,22824,1,216,22665,7648
32,159,22665,22824,-1,216,22824,15840
32,173,22824,22997,1,67,22824,7649
32,173,22824,22997,-1,67,22997,15841
32,56,22997,23053,1,212,22997,7650
32,56,22997,23053,-1,212,23053,15842
32,83,23053,23136,1,180,23053,7651
32,83,23053,23136,-1,180,23136,15843
32,69,23136,23205,1,149,23136,7652
32,69,23136,23205,-1,149,23205,15844
32,96,23205,23301,1,144,23205,7653
32,96,23205,23301,-1,144,23301,15845
32,205,23301,23506,1,238,23301,7654
32,205,23301,23506,-1,238,23506,15846
32,63,23506,23569,1,177,23506,7655
32,63,23506,23569,-1,177,23569,15847
32,237,23569,23806,1,23,23569,7656
32,237,23569,23806,-1,23,23806,15848
32,238,23806,24044,1,76,23806,7657
32,238,23806,24044,-1,76,24044,15849
32,119,24044,24163,1,97,24044,7658
32,119,24044,24163,-1,97,24163,15850
32,116,24163,24279,1,160,24163,7659
32,116,24163,24279,-1,160,24279,15851
32,92,24279,24371,1,207,24279,7660
32,92,24279,24371,-1,207,24371,15852
32,52,24371,24423,1,152,24371,7661
32,52,24371,24423,-1,152,24423,15853
32,108,24423,24531,1,230,24423,7662
32,108,24423,24531,-1,230,24531,15854
32,168,24531,24699,1,185,24531,7663
32,168,24531,24699,-1,185,24699,15855
32,181,24699,24880,1,180,24699,7664
32,181,24699,24880,-1,180,24880,15856
32,128,24880,25008,1,76,24880,7665
32,128,24880,25008,-1,76,25008,15857
32,75,25008,25083,1,192,25008,7666
32,75,25008,25083,-1,192,25083,15858
32,279,25083,25362,1,218,25083,7667
32,279,25083,25362,-1,218,25362,15859
32,69,25362,25431,1,123,25362,7668
32,69,25362,25431,-1,123,25431,15860
32,68,25431,25499,1,137,25431,7669
32,68,25431,25499,-1,137,25499,15861
32,89,25499,25588,1,223,25499,7670
32,89,25499,25588,-1,223,25588,15862
32,114,25588,25702,1,91,25588,7671
32,114,25588,25702,-1,91,25702,15863
32,69,25702,25771,1,64,25702,7672
32,69,25702,25771,-1,64,25771,15864
32,78,25771,25849,1,38,25771,7673
32,78,25771,25849,-1,38,25849,15865
32,140,25849,25989,1,185,25849,7674
32,140,25849,25989,-1,185,25989,15866
32,155,25989,26144,1,40,25989,7675
32,155,25989,26144,-1,40,26144,15867
32,131,26144,26275,1,94,26144,7676
32,131,26144,26275,-1,94,26275,15868
32,91,26275,26366,1,89,26275,7677
32,91,26275,26366,-1,89,26366,15869
32,121,26366,26487,1,239,26366,7678
32,121,26366,26487,-1,239,26487,15870
32,79,26487,26566,1,83,26487,7679
32,79,26487,26566,-1,83,26566,15871
32,168,26566,26734,1,172,26566,7680
32,168,26566,26734,-1,172,26734,15872
32,353,26734,27087,1,173,26734,7681
32,353,26734,27087,-1,173,27087,15873
32,119,27087,27206,1,110,27087,7682
32,119,27087,27206,-1,110,27206,15874
32,42,27206,27248,1,228,27206,7683
32,42,27206,27248,-1,228,27248,15875
32,141,27248,27389,1,25,27248,7684
32,141,27248,27389,-1,25,27389,15876
32,141,27389,27530,1,94,27389,7685
32,141,27389,27530,-1,94,27530,15877
32,110,27530,27640,1,77,27530,7686
32,110,27530,27640,-1,77,27640,15878
32,156,27640,27796,1,153,27640,7687
32,156,27640,27796,-1,153,27796,15879
32,185,27796,27981,1,244,27796,7688
32,185,27796,27981,-1,244,27981,15880
32,191,27981,28172,1,135,27981,7689
32,191,27981,28172,-1,135,28172,15881
32,68,28172,28240,1,113,28172,7690
32,68,28172,28240,-1,113,28240,15882
32,76,28240,28316,1,148,28240,7691
32,76,28240,28316,-1,148,28316,15883
32,69,28316,28385,1,148,28316,7692
32,69,28316,28385,-1,148,28385,15884
32,60,28385,28445,1,16,28385,7693
32,60,28385,28445,-1,16,28445,15885
32,87,28445,28532,1,195,28445,7694
32,87,28445,28532,-1,195,28532,15886
32,106,28532,28638,1,148,28532,7695
32,106,28532,28638,-1,148,28638,15887
32,115,28638,28753,1,219,28638,7696
32,115,28638,28753,-1,219,28753,15888
32,70,28753,28823,1,70,28753,7697
32,70,28753,28823,-1,70,28823,15889
32,48,28823,28871,1,147,28823,7698
32,48,28823,28871,-1,147,28871,15890
32,125,28871,28996,1,208,28871,7699
32,125,28871,28996,-1,208,28996,15891
32,84,28996,29080,1,111,28996,7700
32,84,28996,29080,-1,111,29080,15892
32,119,29080,29199,1,111,29080,7701
32,119,29080,29199,-1,111,29199,15893
32,119,29199,29318,1,32,29199,7702
32,119,29199,29318,-1,32,29318,15894
32,138,29318,29456,1,175,29318,7703
32,138,29318,29456,-1,175,29456,15895
